yoshitune	ヨシツネ
gansekiw	ガンセキ
kuzuokiba	くず置き場
amichang	あみちゃん
kaorin	かおりん
yawatako	やわたこ
mao	まお
shirei kan	司令官
rizume	りずめ
edakichi	枝吉
renamaru	れなまる
ameusagi	雨うさぎ
kame nabe	亀鍋
yuha	ゆは
tanishi	ﾀﾆｼ
kikusan	きくさん
karinosuke	カリノスケ
saradachikinn	サラダチキン
kanata	かなた
hideki	ひでき
momin ji	もみんじ
sato	さと
akikaze	秋風
makoto	まこと
kinkirahoipp	キンキラホイップ
kensuou	けんすおう
reo	レオ
kajiki	カジキ
makai	マカイ
yuusan	ゆうさん
suzushi	すずし
hiori nyan	ひおりニャン
sakura	サクラ
itatsu	いたつ
nemoren	ネモレン
hokahokamanjuu	ほかほかまんじゅう
guchiyama	くちやま
ranmaru	蘭丸
konekochan	子猫ちゃん
yuru	ゆる
nowa	ノワ
shishamo oishii	ししゃもおいしい
myurara	みゅらり
sawanolemon	澤野檸檬
machintamu	まちんたむ
esekansaijinda	エセ関西人
iadan kopipe	イアダンコピペ
yayuyo	やゆよ
ichimtsu	イチマツ
yamachan	やまちゃん
fukenkou	不健康
furuido	ふるいど
yakumo	八雲
tomochi	ともち
yuzu	ゆず
amamiyaritsu	雨宮律
minechin	みねち
tai desuyo	鯛ですよ
ripu gonzaresu	リプゴンザレス
asunaro	あすなろ
hisui	ひすい
migozuku	みごずく
hangorolin	はんごろりん
kamechitanaka	カメッチ田中
robo	ろぼ
bou cha	ぼぅちゃ
juju	呪呪
takopoco	たこぽこ
zura	ヅラ
orusuta	おるすた
fuiriifu	フイリイフ
shinosuke	しのすけ
tama	タマ
mimi kyu	みみきゅ
mikuteku	みくてく
tama kujira	たま鯨
tomozu	ともず
yapi	やぴ
nagomi	なごみ
kurogoma	くろごま
isao	いさお
matsuko	まつ子
miya kazu	みやかず
nikuo	にくお
yuzukichi	ユズきち
heyakita	へやきた
wase	早生
kurowa	くろわ
denomotan	電おもたん
wako shiro	和光しろ
maru	まる
mizuno	水野
daizu	だいず
hitomiiko	ひとみいこ
yukineko	雪ねこ
aru	ある
takana	たかな
nakken	なっけん
chihomi	ちほみ
nie	にぇ
sakura	サクラ
itaden hanamiya	イタ電花宮
senbexe	せんべぇ
emoto mashimesa	江本マシメサ
womuretu	をむれつ
yakumi	やくみ
minisere	みにせれ
doramusu	どらむす
aoharu	アオハル
yukimushi	ゆきむし
raputoru	ラプトル
amagasa ryuren	雨傘流連
rikunagi yuu	陸凪ユウ
akiho keiba	あきほ競馬
pehede	ぺへで
kaeru usagi	蛙兎
yatogami	やとがみ
narasann	ならさん
rukichi	ルキチ
pan	ぱん
purikun	ぷりくん
munpapi	むんぱぴ
ikumi	いくみ
shino	しの
nasumoku	なすもく
mana	まな
tarepanium	たれぱにうむ
dozounonyaka	土蔵のにゃか
konkou	こんこう
rin	りん
nousu u	ノウスウ
ran	らん
mikuras	ミクラス
ao	あお
inori	いのり
podenkun	ぽでんくん
yachui	やちゅい
usakokaeru	うさこカエル
dakkonn	だっこん
migaki pon	みがきポン
paku chi	ぱくち
yuusuke	ゆうすけ
hirota	廣田
sakiika	さきいか
mihochin	美穂ちん
yotsuba	四葉
nagi	なぎ
makaron	マカロン
noppe	のっぺ
kanakichi	かなきち
shitorera	シトレラ
holoukekamui	ホロゥケカムイ
saihosi	さいほし
darayama	ダラヤマ
dein	デイン
namappe	なまっぺ
maki	まき
runjiro	るんじろう
imunomori	いむの森
yudecchi	ゆでっち
okazora	おかぞら
asupara	アスパラ
kaju	かじゅ
hakumei akashi	薄明アカシ
shichi ka	しちか
nishipppe	にしっぺ
mitsuo	みつお
mukkoro	むっころ
myau kikaku	みゃう企画
siriusu	シリウス
take	たけ
kazu	かず
ryoochan	りょうちゃん
michirushi	みちるし
hime	姫
npapapa	んぱぱぱ
erika	えりか
sakurai itsumi	櫻井いつみ
unko kunimi	うんこ国見
ittousei	一等星
mikuras	ミクラス
kuroimegane	黒井眼鏡
kakinyako	かきにゃこ
inukisi	イヌキシ
niwasan	にわさん
ayami	あやみ
kiichi	きいち
kiyu	きゆ
mikirukate	生きる糧
kapihami	カピハミ
donkyuusai	鈍九斎
pekorun	ペコるん
aika	藍架
sekidousai	赤道斎
zazaboon	ざざぼーん
kieiro	きえいろ
miyatake	ミヤタケ
yamori	ヤモリ
tujimori	つじもり
sakana	さかな
mito	みと
ryokucha	緑茶
uchimomoniku	うちもも肉
nacchan	なっちゃん
nanonanao	なのななお
aoi	葵
nekozoone	ねこぞーん
haruurara	ハルウララ
kesera	ケセラ
noazami	のあざみ
sugita	スギタ
moko	モコ
juri	樹里
kungisa	クナギサ
konkaron	コンカロン
ayaha	綾葉
punsuka	ぷんすけ
aruchan	あるちゃん
tamura hiyori	田村ひより
panme	ぱんめ
lokimaru	ロキまる
gizura	ギズラ
momodaisuki	もも大好き
nanaonao	ななおなお
danna	旦那
macha oji	まちゃおじ
yatohana	ヤトハナ
katsutake	カツタケ
shiba touma	司馬当麻
yumemura	ゆめむら
yui	ゆい
mao	まお
cho san	ちょーさん
santamama	サンタママ
yoshimizu	よしみず
narita	成田
toro	トロ
umi	うみ
seriha	芹葉
noshin	のしん
chocoru	ちょこる
tomocho	ももちょ
miu suzuriha	ミウスズリハ
kasugasumomo	春日すもも
poyu	ぽゆ
yoshitaka	よしたか
hinaki	ひなき
yuzuki	ユズキ
kimidori	きみどり
ankou	あんこう
himamusi	暇虫
kanpan	かんぱん
chibineco	ちびねこ
mukkoro	むっころ
piroshi	ぴろし
sugimisu	スギミス
miso	みそ
yuipyon	ゆいぴょん
kuzumo	クズモ
tomomo	ともも
pahisuroyarou	パチスロ野郎
juju	じゅじゅ
funamura	船村
tamago	たまご
tamo	たも
nashiko	なし子
ra gora	らごら
mihopapa	みほぱぱ
myouga	ミョウガ
drakuro	ドラクロ
mao	まお
soranomameko	そらのまめこ
furemu	ふれむ
natsuisara	夏井さら
guhehechan	ぐへへちゃん
fujitsu	ふじつう
yayoi	弥生
kiritani hitomi	桐谷ひとみ
ryuka	リュカ
nayuki	菜雪
hasuwap	はすわ
ichino	いちの
asami	あさみ
mayu	ﾏﾕ
tsuginohihare	つぎのひはれ
fukapyon	ふかぴょん
kyanoru	きゃんおる
nou	脳
kyo suke	きょーすけ
kaabiii	かーびぃ
danmaru	ダン丸
renon	れのん
kagetsu shion	花月しおん
bukininn	武器忍
yuzu	柚子
kirumi shibu	キルミシブ
ami	あみ
yukiyuna	ゆきゆな
niiwa	にいわ
otafuku	オタフク
mizuki yuri	水樹百合
sasa	ささ
sakuranbo	さくらんぼ
kojo	コジョ
yun	ゆん
ata	あた
pupipo	ぷぴぽ
motunabe	もつなべ
ochatousan	おちャ糖まん
yuki sakura	雪桜
inupyon	犬ぴょん
tukimisou	月見奏
pandaman	パンダマン
hina	雛
matubara	まつばら
micha	みちゃ
fuwafuwasan	ふわふわさん
irugisu	イルギス
tomtanaka	トム田中
takamaru	たかまる
fuyu enoki	ふゆえのき
ushijimamasato	牛島正人
samidaresensei	五月雨先生
yamiwa	やみわ
kado mi	かどみ
geba	ゲバ
ta kuro	たくろ
asagiri	朝霧
shizu	しづ
yupiwo	ゆぴを
kagami	鏡
aki	アキ
sawa	サヮ
shiratama	しらたま
zono	ゾノ
bei	べい
sora	そら
takamarusuisan	たか丸水産
amen osora	あめのそら
seironsennsei	正論先生
dorukuma	どるくま
mio	みお
roku yuurei	六幽霊
mameta	豆太
masapou	まさぽぅ
kogepink	こげぴんく
kojika	こじか
unngoki	うんゴキ
airi	あいり
furifurimomo	フリフリモモ
yokubarisu	ヨクバリス
medi aka	メディアカ
yo ssan	よっさん
mayotuna	まよつな
saki	さき
kozue	こずえ
nohito	のひと
otsukenn	おつけん
akaneko	あかねこ
suzukaken	スズカケン
nanohana minto	菜の花ﾐﾝﾄ
yosirin	よしりん
shigao	しがお
yamabuky	ヤマブキ
usataivu	ウサタイブ
antananarivo	アンタナナリボ
kaze	風
soryonn	そりょん
tanayuki	たなゆき
shizuru	しずる
memeyachan	めめや茶
yumemakura	夢まくら
riri	りり
azumine	あずみね
rupipon	るぴぽ
haineko	灰猫
kaguhakobi	家具運び
shunta	駿太
gizura	ギズラ
sakuraoi	桜葵
haybusa	はやぶさ
kakko	かっこ
nasu bi	なすび
toki	鴇
mekajiki	めかじき
amakusa	あまくさ
shio	しお
nimono	にもの
ramu	ラム
shitami	したみ
amemiya byakuya	雨宮白夜
suzaku	スザク
jinrakuaiichi	人楽愛一
kimayun	きまゆん
so machin	ソーマチン
fuyuyu	ふゆゆ
satori	さとり
kino	きの
daiki	だいき
onekun	おねくん
totomagg	ととまぐ
otoko	おと子
robfuku	ろぶ福
saba	さば
sakusaku	さくさく
kurokome	黒米
muumi	むぅみ
amin	あみん
yasosuke	やそすけ
jakoonezumi	じゃこうねずみ
yoshikawa	ヨシカワ
kamikitakomari	かみきたこまり
anpan	あんぱん
yuina	ゆいな
dokkesu	ドッケス
ayagakiyuki	あやがきゆうき
shigure	しぐれ
yukikaze	ゆきかぜ
neko majo	ねこまじょ
ari	あり
guraburu	ぐらぶる
kaede	かえで
buta chanko	ぶたちゃんこ
chinta otamu	ちんたオータム
rokka	ろっか
kinkirahoipp	キンキラホイップ
meu	めう
haibikun	ハイビ君
tamamizu	玉水
fushiko	ふしこ
yuumi	ゆうみ
rio	りお
haa	はー
pyoko	ぴょこ
kiina	キイナ
kyon	きょん
risanav	りさな
mahama	まはま
chomu	ちょむ
yunyunp	ゆんゆん
takahashinameko	高橋なめ子
nano	なの
kokonotu	ここのつ
metappou	メタッポウ
reito	玲斗
ka royoshi	かろよし
onikure	おにくれ
hiyori	日和
heki	碧
kamemoto kie	かめもときえ
shigure	時雨
ahokusa shirou	あほくさ四郎
edamame	エダマメ
kokoroko ko	こころここ
miyukin	みゆきん
pengin	ぺんぎん
kozakku	コザック
daimaru	だいまる
choko	チョコ
rarudango	ラル団子
aina	あいな
sousuke	そーすけ
hiyoko	ひよこ
rio	りお
sana	さな
kotobuki	ことぶき
yamashiro	山城
kanakeke	かなけけ
bangren	バンレン
umeko	うめこ
urusaishiwasu	五月蝿い師走
shinohara	しのはら
kurorone	くろろん
aabakadana	ああバカだな
ejirin	えじりん
izakaya furuya	居酒屋ふるや
hiron	ひろん
shijimi	しじみ
sumomo	スモモ
washimi	鷲見
mamazame	ままざめ
nika	にか
maroyakana mizu	まろやかな水
aimi	あいみ
remi	れみ
taru	たる
tafuocu	タフオク
murasaki	むらさき
hibikiai	ひびき藍
youshikibi	様式美
mugyugyu	むぎゅぎゅ
ukogi	うこぎ
makichi	まきち
natsu	なつ
masakishinya	正木慎也
usagisan	兎さん
fumi fumi	ふみふみ
kurinezum	栗鼠
komyu	こみゅ
amemiya byakuya	雨宮白夜
kusuriya tantei	薬屋探偵
maikun	マイ君
orurai	おるらい
kano	かの
chibiusachan	チビうさちゃん
haren	ハレン
hitochi	ひとち
tatsuya	たつや
ryu kun	りゅくん
miku	みく
nozepoyo	のぜぽよ
hiyori	日和
hisa	ひさ
takutakue	たくたくえ
marimo	マリモ
vorira	ゔぉりら
aiueo	あいうえお
imabari yuka	今治ゆか
umu	う無
bu ruku	ブルク
dakkoara	だっこあら
begaroka	べがろか
yume	ユメ
manamonano	まなもなの
ajisai	あじさい
furuido	ふるいど
raratan	ららたん
momo	もも
au	あぅ
memochan	めもちゃん
noa	のあ
mogetam	もげ太
ima	いま
yayosun	やよさん
neko oyabun	猫親分
neochikareshi	寝落ち彼氏
masaya	まさや
toragusu	寅楠
kantaro	かんたろ
toi	とい
bayashi	バヤシ
mongorungo	もんごるんご
tatsumi	辰巳
guraemon	ぐらえもん
yunnbeko	ゆんべこ
takaten	たかてん
arechi	あれち
murapen	ムラペン
kiku	菊
naru	なる
samechi	さめち
bansan	バンサン
higekumagorou	ヒゲくまごろー
nireki	楡木
yuusan	ゆうさん
conayuki	粉雪
poka poka	ぽかぽか
akasaka	あかさか
matatabi	マタタビ
taiyaki	たい焼き
anko	あんこ
pinya	ぴにゃ
tanishi	ﾀﾆｼ
aki	アキ
ikuyumu	いくゆむ
gajumaru	ガジュマル
yaga pan	やがパン
tebasaki	てばさき
yuki	ゆき
kumikomm	クミコム
fukuchi	福地
toumuin	とうみん
murapen	ムラペン
nishipppe	にしっぺ
yunakazu	ユナカズ
yama purikone	山プリコネ
towa	とわ
hiro	ヒロ
asuparagasutaro	アスパラガス太郎
muhei sarumi	むへいさるみ
mineiyutaka	嶺井豊
rinna	凛那
nanona	なのな
damedamewanko	だめだめわんこ
kurotarou	黒太郎
ponzu	ぽんず
ai mana	あいまな
chika	知佳
kotatsuinu	こたつ犬
kuma	くま
atugetan	アツゲタン
akuneno	あくねの
ikarimanatu	碇マナツ
sayu	さゆ
shiodoki	潮時
gafatie	ガファティエ
genmaitabeko	玄米たべこ
atsuka	あつか
hiyori yuzu	日和ゆず
akimin	あきみん
huwakokuou	ふわ国王
yahaku	やはく
ueeee	うええええ
ria	莉亜
izayoi	いざよい
pepechi	ぺぺち
na kajou	ナカジョウ
sasamegu	ささメグ
sayu	さゆ
kerorrin	けろりん
yudecchi	ゆでっち
moe	もえ
chinako	ちなこ
warewaredan	我々団
yudecchi	ゆでっち
yukihiro nanaka	幸弘ななか
urisan	うりさん
kosuzu	胡鈴
ryu	りゅ
daroa isu	だろぁ椅子
nanriu	ナンリウ
reri	レリ
numauo	ぬまうお
mamemosi	マメモシ
chiisuke	ちーすけ
nijiokasan	虹岡さん
uraniwa	裏庭
suzuno	鈴野
sakura	さくら
goripon	ゴリぽん
kodoku osakana	孤独な魚
takenohana	竹の花
shigesyan	しげしゃん
moru	もる
nakayakik	中屋キコ
nekomu	ねこむ
talutoru	タルトル
asa botan	あさぼたん
narikesoji	なりけそじ
naposhita	なぽした
shuri	シュリ
turikichi	釣りキチ
ayupon	あゆぽん
gitaharo	ギタハロ
dateatsushi	伊達敦
moyashi	もやし
zakura	ざくら
ruto	ると
shiramizo	白溝
azarasi	あざらし
gotoukatuhiko	後藤勝彦
kasumi	かすみ
ninsougaku	人相学
sumiya	スミヤ
fuuri	ふうり
andonkurage	あんどんくらげ
kabigon	カビゴン
nanaba	ななば
uchiko	うちコ
fushimi yuki	伏見由紀
kuriyama	栗山
sanocchi	さのっち
penkama	ぺんかま
siromiyayukino	白宮雪乃
kani	かに
metappou	メタッポウ
rue	ルエ
soruto	そると
koyuki	コユキ
aori	あおり
kaorinp	かおりん
sukebeaki	すけべえあき
masaya	まさや
manekineko	招き猫
yukiguni	雪国
hitomi	ひとみ
okura	おくら
monana	もなな
azu same	あず鮫
enma	えんま
shiro	シロ
mamesora	豆空
mirin	みりん
tobitanuki	とびタヌキ
aya	あや
bono	ぼの
moppan	もっぱん
aoneko	蒼ねこ
sethuna	せつな
doguu	どぐう
kikiyan tanuki	ききやんこたぬき
yurari	ゆらり
shiratama	しらたま
umaaji	うまあじ
littorio	りっとりお
riichan	りーちゃん
oiranonoriko	おいらの典子
pattsuan	ぱっつあん
kametaro	かめたろう
mutsumi	ムツミ
nanashino	ななしの
hagina	萩奈
wasimaro	鷲麻呂
ojaemon	おじゃえもん
yoko	よこ
nepu	ねぷ
kuri	くり
chinori	ちのり
hirai	ひらい
suieibu aruaru	水泳部あるある
mio	みお
hiyo	ひよ
yorika	よりか
shinkeihan	しんけーはん
asparamaru	あすぱらまる
sakurayuki	佐倉悠紀
usagida	兎田
nekotamamizuki	ねこたまみずき
sakana	さヵな
massun	まっすん
kincyan	きんちゃん
kanamea	かなめあ
nukodangon	ぬこだんご
mi yazaki	みやざき
sakurak	さくら
hirudoa	ひるどあ
saresare	されされ
ao	蒼
kawanotebukuro	革の手袋
yume	ゆめ
sena	瀬那
himari	ひまり
zawa	ざわ
non	のん
noma	ノマ
sayo	紗余
tokudane	とくだね
macha oji	まちゃおじ
akuakua	あくあく
rune	ルネ
oomitarou	近江太郎
kuwaaaman	クワーマン
natsuki	なつき
talutoru	タルトル
manmaru	まんまる
kaatan	カータン
ishikawa hari	石川ハリ
itoudaijirou	伊藤大二郎
ramiton	ラミトン
nekobaka	ネコばか
ichihiko	いちひこ
sangon	さんごん
natumehouseki	夏目宝石
kinjonooniisan	近所のお兄さん
romonemo	ろもねも
kino	きの
amano	あまの
kippo	きっぽ
bunmaro	ブンマロ
wabirukai	ワビル改
ibuki	伊吹
umai maru	うまい丸
neko	ネコ
sua chun	すあちゅん
taiyaki	たいやき
oyajiseikatsu	オヤジ生活
ipponmaru	いっぽん丸
kazushi	かずし
kayoyon	かよよん
shinjinx	しんじん
yuribow	ゆりぼう
runa	ルナ
miyao	みやお
kusooyaji	クソ親父
ayuto	あゆと
momodaisuki	もも大好き
peke puu	ぺけぷぅ
umeshimeji	うめしめじ
chousuke	ちょうすけ
rio	りお
maria	まりあ
momoko	ももこ
ankake	あんかけ
kirenunko	キレヌンコ
yawara	やわら
tubuyume	つぶゆめ
murakurou	むらくろう
piorichan	ぴおりちゃん
mumudera	ムムデラ
poniiki	ポニーキー
chiyogamil	ちよがみ
hibiki	ひびき
aina	あいな
pie	ぴえ
kiregimichan	キレ気味ちゃん
umasika	うましか
beru ouen	ベル応援
kamishiro	カミシロ
ayamitsu	あやみつ
aoi	葵
kakerun	かけるん
imari	伊万里
nmizuki	みづき
akamakkyi	あかマッキー
harucha	はるちゃん
asuka	あすか
ishiinoboru	石井昇
kuriko	栗子
sunekosuri	すねこすり
nijimikan	にじみかん
asahikamen	あさひかめん
sihainu	しは犬
ran	乱
hanamaruko	はなまるこ
kenniko	ケンニコ
mako	まこ
tomomin	ともみん
ukyou	右京
hasu	蓮
katsuyann	かつやん
sakunatsu	さくなつ
yoshineko	よしねこ
riona	りおな
nagomi	なごみ
kamakurapasta	鎌倉パスタ
nishihara nanako	西原奈々子
forobane	フォロバネ
yamosabo	やもさぼ
rii	りい
sakurai	サクライ
hitomisunaga	ヒトミスナガ
eha	えは
rikanojikan	理科の時間
torine	とりね
mauru	まうる
feraime	フェライム
hazuki	葉月
naohiro	ナオヒロ
tmichiaki	みちアキ
yuri	ゆり
nekohukumen	猫覆面
koishi	小石
kamitaku	かみたく
shin	しん
sirokuma	しろくま
yamimaru	闇丸
yuma chiyo	ゆまちよ
iorin	いおりん
yakitori	やきとり
afusu	あふす
ayato	絢斗
ken	けん
toshiaki	としあき
abunishu	アブニシュ
harucyan	はるちゃん
chiaki	ちあき
nyuutoraru	にゅーとらる
nekonokotatu	猫のこたつ
rar agi	ららぎ
uju	うじゅ
namame	菜豆
kagijirou	かぎじろう
ririchan	リリちゃん
onigiri	おにぎり
rinnote	りんの手
maosuket	まおすけ
natumehouseki	夏目宝石
morishi	森氏
okayamaipponpp	おかやまいっぽん
inaho minori	稲穂みのり
sonjo	そんじょ
oreo	おれお
hikarino ozisan	光のおじさん
araiwa	あらいわ
howaran	ほわらん
nevadan	ネヴァダ
shimamelon	しまメロン
matcha	抹茶
natsu kaze	なつかぜ
aura	アウラ
kurosuke	くろすけ
kawau	かわう
azusa wa	アズサワ
okaeri udon	おかえりうどん
sorairo	ソラいろ
yamainu	やまいぬ
menchi	めんち
nangororo	なんゴロロ
miyaguzi	ミヤグジ
koa	こあ
kanaemon	かなえもん
tochirou	トチロー
myako kuriine	ミャコクリーネ
fukuchan	ふくちゃん
kamisiro	かみしろ
kamo me	かもめ
kurotoma	くろとまェ
masanyan	まさにゃん
yuyu	ゆゆ
takurou	ﾀｸﾛｳ
zensyoutarou	全商太郎
toshikin	としきん
maname	まなめ
channao	ちゃんなお
kouna	こうな
kyurio	キュリオ
inutose	いぬとせ
ringoame	りんご飴
gai kun	ガイくん
oochii	おーちー
akaneko	赤猫
yuuwann	ゆうわん
chapo	ちゃぽ
hinocchi	ヒノッチ
innaka	いんなか
iwatobi hajime	岩鳶ハジメ
posinon	ぽしのん
yae	やえ
uhamomo	うはもも
shishimaru	ししまる
nanimonoka	なにものか
nemusuke	ねむすけ
rumarato	るまらと
suzu me	すずめ
tomomix	ともみん
chacha	ちゃちゃ
kyon	きょん
mina	ミナ
massa	マッサ
hirunokagayaki	昼の輝き
robina	ロビナ
tonmii	とんみぃ
chikasa	チカサ
makinanami	マキナナミ
sekken	せっけん
kamimama	かみまま
harada	原田
omosiro kopipe	面白コピペ
rina	りな
homeron	ホメロン
chitosa	ちとさ
akuchan	あくちゃん
runazinku	ルナジンク
dezaiya	でざいや
ojiji	おじじ
haribote	はりぼて
yasu	やす
eringi	えりんぎ
tomokichi	ともきち
techi	てち
ameusagi	飴うさぎ
oitake	おいたけ
mutsumi	むつみ
yamana	やまな
harineko	針猫
kabukin	かぶきん
suzune	すずね
ashioto	あしおと
asuka	あすか
saya	さや
rarirunemomiko	羅璃瑠禰摸魅瑚
gorichan	ゴリちゃん
minagawa aoi	みながわあおい
dorirun	どりる
yuzuru	譲
jonasan	じょなさん
arinko	アリンコ
yasumasa	ヤスマサ
misaki	みさき
yoza min	よざみん
hijiki	ひじき
itoi minamo	糸ヰみなも
hamanasu	はまなす
muumi	むぅみ
kimoota buhiiii	キモオタぶひぃい
hitomisan	ヒトミサン
emoto mashimesa	江本マシメサ
kaatochan	かとちゃん
mamedaihuku	豆大福
umebosioritore	うめぼしおりとれ
kannpachi	かんぱち
netahougaii	ねたほうがい
fuafua	ふあふあ
rinkoro	りんころ
monika	モニカ
viru	ゔぃる
akutagawa masao	芥川まさお
mamuniya	まむにゃ
shiro	シロ
yureru kusamura	ゆれる草むら
yocchan	よっちゃん
yuuku	ユーク
hanahana	はな花
fumiko	ふみこ
hikarin	ひかりん
ochin	おちん
yuragi	ゆらぎ
yanun	やぬん
kokera	こけら
ningen yashi	人間やし
morikogiw	モリコギ
kotan	こたん
shutei	しゅてぃ
shioame	しおあめ
yutokun	ゆうとくん
hidarime	ひだりめ
maroa	マロア
yukkuritosi	ゆっくり敏
sumire	すみれ
sazuka	サズカ
hanbunnotume	はんぶんのつめ
tekunomo	てくのも
kuma	くま
isoiso	イソイソ
yotsubanegi	よつばねぎ
teieryu run	てぃえりゅうるん
kiyosuke	きよすけ
matchan	まっちゃん
tocochin	とこちん
kogeteru	焦げてる
kurautu	くらうつ
fuu	ふぅ
torihiki	取引
souen	ソウエン
nagina	なぎな
chankaho	ちゃんかほ
shirako	しらこ
sachi	さち
daruhata	だるハタ
anto	アント
aruko	あるこ
rian	りあん
okayu	おかゆ
unyarin	うにゃりん
metappou	メタッポウ
chiipapa	チーパパ
ru ruru	るるる
parame	パラメ
inosan	いのさん
ayumun	あゆむん
nakam ura	なかむら
kaaya	かぁや
akinohikage	あきのひかげ
pipizawachan	ぴぴざわちゃん
ayanon	あやのん
ginnosuke	ぎんのすけ
gorori	ゴロリ
oniisan	お兄さん
anesakisu	あねさきす
minato	みなと
shunya	駿ヤ
usagiotoko	うさぎおとこ
mokao	もかお
subaru	昴
otoi aya	音井あや
tane	たね
mochidayori	もちだより
kasei san	かせいさん
kanna	かんな
aonokurage	蒼乃海月
gumi	ぐみ
chunyuta	ちゅん由汰
nyun	にゅん
aoisora	あおいそら
dattan	韃靼
hanari	はなり
kamiyan	かみやん
zyoshidaiseinon	女子大生のん
yoshidahachi	吉田ハチ
eruto	エルト
miroku	みろく
ierahoki	いえらほき
mumu	むむ
koppepan	こっぺぱん
rei kun	黎くん
oyajiseikatsu	オヤジ生活
nanashiya	ななしや
natsumi	ナツミ
iori	伊織
oyajiseikatsu	オヤジ生活
pepo	ぺぽ
minoru	みのる
suzu	すず
higu	ひぐ
wabirukai	ワビル改
kika	きか
meikun	めいくん
katomiriyakashi	加藤ミリヤ歌詞
osamu	おさむ
hakuryu	白龍
amamizu	雨水
kurotoki	黒時
maoko	マオ子
kabocaha	カボチャ
mako	まこ
naoya	ナオヤ
sobadanuki	蕎麦貍
migimimi	みぎみみ
ike rika	池江璃架
misuzu	美鈴
adonisu	アドニス
konikoni	こにこに
sewashi	セワシ
botamochi	ボタモチ
kuria	くりあ
yama giiyama	ヤマぎーやま
perie	ペリエ
ahokusa shirou	あほくさ四郎
aruru	あるる
bayashi	バヤシ
morigonn	もりごん
katsuguma	カツグマ
mits ugi	みつぎ
rapeechu	らぺーしゅ
shunkoromochi	しゅんころもち
miruku	みるく
tsubaki	つばき
sasuga	流石
sanocchi	さのっち
piyochan	ピヨちゃん
mega mame	メガまめ
maa mei	まぁめい
kanon	かのん
kenpoint	けんぽいんと
petaruchi	ペタルーチ
kamakurapasta	鎌倉パスタ
gorori	ゴロリ
naru	ナル
aasan	あーさん
mihokuma	みほくま
surippa	すりっぱ
kaibasira	カイバシラ
neko kan	ネコ缶
kurosaki	くろさき
naochan	なおちゃん
yunha	ゆんは
yumeusagi	夢うさぎ
taka	鷹
shimoigusashu	下井草秀
aruru	あるる
yuzuringo	ゆずりんご
naoki	なおき
sirousagi	白うさぎ
kapibara	カピバラ
nocha	のちゃ
ykumasan	クマさん
wanta	わんた
katawara	かたわら
mochiyuri	もちゆり
hosokawa	ほそかわ
touyama aki	とうやまあき
komayuki koma	狛雪コマ
shojikikun	正直くん
yamosabo	やもさぼ
gekichin	げきちん
kurikuri	くりくり
dugizamomomi	づぎざももみ
chauchinankou	ちゃうちんあんこう
nanatuki	ななつき
tatsuya	たつや
hisame	氷雨
nunnun	ぬんぬん
godaemoon	ゴダえもん
yuuhaya	ゆうはや
tsuruse	つるせ
tokoton	トコトン
yu nori	ゆうのり
innaka	いんなか
shima  takahiro	しまタカヒロ
mirin	みりン
hirai nami	ひらいなみ
nogami chitose	ノガミチトセ
kiyokazu	キヨカズ
kakerun	かけるん
okki	おっき
kochi	こち
apyapon	あぴゃぽん
shizuku	しずくぅ
isaki	いさき
hosyunyan	保守にゃん
fukuyuuu	ふくゆー
kansho	かんしょ
maripem	まりぺむ
kujira	鯨
pauncyo	ぱうんちょ
haniwatarou	はにわたろう
tamako	たまこ
atorukk	あとるく
miharu	みはる
maikeru	まいける
sagato	さがと
mii	みぃ
miu	みう
ahiru	あひる
harutya	ハルゃ
man	万
yura	ゆら
asuka	あすか
mmakopon	まーこぽん
piroki	ピロキ
hiryupon	ひりゅぽん
surou	スロウ
junka	順遐
kuniyata	くにやた
teke	てけ
gachi	ガチ
suzunaris	すずなり
chisa	ちさ
yama	やま
arasuka	アラサカ
mako	まこ
ahoneko	アホ猫
shigure	しぐれ
matsuo	まつお
azusa wa	アズサワ
wakari tetsuya	わかり哲也
ikuru tantan	いくるたんたん
norishiro	のりしろ
asadamiyu	あさだみゆ
pekoro	ペコロ
maruru	まるる
ojiraiyan	おぢらいやん
teku son	てくそん
tsu tsu	つつ
aburadakos	あブラだこす
mohiko	もひこ
miyamot	宮本
doreichou	奴隷長
inumaru	いぬ丸
choki	ちょき
naka mamita	仲まみ太
misuzu	みすず
akaishi mai	赤石マイ
rinrin	りんりん
sutetekoten	ステテコテン
sora	そら
mizuki	みずき
masanashi	マサナシ
nao	なお
shachimaru	しゃちまる
okutan	おくたん
wami	わみ
karuma	カルマ
unchan	うんちゃん
yhikari	ひかり
kako	かこ
zawamin	ざわみん
sachinoka	さちのか
gomipi reiji	ゴミピレイジ
tobidasi sensei	飛び出し先生
furipara	フリパラ
zannensyunin	残念主任
pucho	ぷちょ
shirako	しらこ
suzuhiro	すずひろ
kana	かな
kaitenma	回転魔
kusunoki mikoto	楠ミコト
chocottonochoco	ちょこっとのチョコ
kazuha	かずは
ayase	あやせ
kurousa	クロウサ
yamai	山威
asagiimao	あさぎりまお
hayashiba	林葉
saki	さき
sanshichi	さんしち
majikayo	まじかよ
irukujira	イルクジラ
kodama	木霊
mirin ko	ﾐﾘﾝｺ
nyagoponn	にゃごぽん
kumazeno	熊ゼノ
matsuoyuu	松尾優
fuyu	ふゆ
funa	フナ
akaneko	あかねこ
sasuga	流石
von	ヴォン
tenten	てんてん
munieru	ムニエル
shimazuyoshirin	島津よしりん
hizumi	歪
tomiwo	とみを
fujino	藤野
suika	すいか
hina	雛
kumasechi	くませち
akatsuki	暁
mariya	まりや
morigeny	もりげん
aikoku sayoku	愛国左翼
kikkoro	きっころー
daichan	だいちゃん
oto	おと
shishio gai	獅子王ガイ
asimaru	あしまる
mayako	まやこ
nikupoteyaroo	肉ポテﾔﾛｩ
nebukuro	ネブクロ
takerenon	竹レノン
teide kei	テイデケイ
chizuru	千鶴
kako	かこ
hakuru	はくる
tsumurin	つむりん
yasaseka	やさせか
hoehoe	ほえほえ
dozuhiko	どずひこ
butsurizuki	物理好き
uriu	うりう
harumaki	ハルマキ
asakawarin	朝河凛
ani	アニ
kurokemu	くろけむ
nobirin	のびりん
fujimiya	ふじみやん
neru	ねる
tsubaki	つばき
tamagopan	たまごパン
akaru	あかる
ki	キ
rokunoshin	ろくのしん
nekozakana	ねこざかな
kei	けい
jussai	じゅっさい
minori	みのり
sasasaboo	サササボー
take	竹
nenu	ネヌ
toyoninkun	とよにんくん
rikari	リカリ
akame	アカメ
okiku	お菊
kyousann	今日さん
tai yaki	たいやき
kimio	きみお
mugenimu	むげにむ
yokota	ﾖｺﾀ
ninyau	ににゃう
daichan	大ちゃん
mahirokun	まひろくん
shiro	シロ
eruu	えるぅ
kokoro	こころ
hareru haru	はれるはる
sayagi	さやぎ
honono niton	ホノノニトン
rei	零
tarosuke	たろすけ
yu yakechoucho	夕焼けちょうちょ
hanabi	花火
kari	かり
moja	もじゃ
naochimaman	なぉちままん
mauru	マウル
sudachi	すだち
wankonokojiro	ワンコの小次郎
hirokonuna	ひろこぬな
hadekait	派手カイト
maruta	まるた
kouichi	こういち
aruru	あるる
takanabe kun	高鍋くん
mio	みお
yahaku	やはく
ichigo	いちご
chao	ちゃお
kokumaro	こくまろ
tochuaco	とちゅあこ
ratani	らたに
yasu	やす
momonochaya	桃乃茶屋
azuma	吾妻
sakurabiamane	さくらびあまね
wanineko	鰐猫
jou	じょう
yuki	ユキ
sora	そら
asa giri	あさぎり
goetaro	ごえたろ
katorisenko	かとりせんこー
moka	もか
isasa	いささ
ochamaru	お茶丸
ten	天
aika	愛果
inui	いぬい
aru	アル
kamitaku	かみたく
yabumip	矢文
muruun	ムルーン
rei	零
reito	玲斗
yuunaroon	ゆうなろん
urako	うらこ
yuki	ユキ
benihoku	べにほく
toneunga	利根運河
kyabetsu	きゃべつ
nakasan	なかさん
echinaba	えちなば
hinarno	ヒナーノ
komekue	コメ食え
wakakuma	わかくま
kandabako	神田箱
tamayurakana	タマユラカナ
tooka	とおか
peroyan	ぺろやん
suzunekomaru	すずねこまる
mikan	みかん
zugashira	ズガシラ
awa	あわ
shirokuma	ｼﾛｸﾏ
yamazaki toyama	やまざきとやま
gyanburupapa	ギャンブルパパ
myiyano	ミヤノ
yuzuyume	柚子夢
morichamo	もりちゃも
abe chi	あべち
sirataki	しらたき
kumaneko	熊猫
tanakatakaaki	田中たかあき
gomidamechan	ごみ溜めちゃん
taimama	たいママ
shioaji	シオアジ
aki	秋
micoron	みころん
neko oyabun	猫親分
temisuma	てみすま
harussan	はるっさん
natumehouseki	夏目宝石
kanii	かにい
kawa nyan	かワにゃん
hirakihokke	開きほっけ
kotone	琴音
saihatenousagi	さいはてのうさぎ
maru	まる
kiri same	きりさめ
ugosaburoudokei	うご三郎時計
rikka	立夏
charisu	ちゃりす
ada pon	アダぽん
gai	ガイ
non	のん
kiaimushi	気合虫
minamidori	みなみどり
nato	なと
mopiemon	もぴえもん
shinkokyuuu	深呼吸
enso	塩素
minori	みのり
sabu	さぶ
shomodoki	しおもどき
gachi	ガチ
ayakari	あやかり
kantarou	観太郎
tohazugatali	とはずがたり
chanaka	ちゃなか
motunabe	もつなべ
yuzuchan	ゆずちゃん
ginzanx	ぎんざん
tagaryo	たがりょう
kaze	かぜ
ryuuuto	りゅーと
nyarucha	にゃるちゃ
pan	ぱん
utausakana	歌う魚
chiesha neko	知恵捨猫
morimori	もりもり
namepuri	なめぷり
chadanchy	茶団地
sasakiyoshiaki	佐々木義明
ekusupuroidar	エクスプロイダー
kamakurapasta	鎌倉パスタ
ringo	りんご
sakurashiki	さくらしき
mii	みー
nono	ノノ
mayorun	まよるん
tetsutsu	テツツ
rui	ルイ
mayone	まよね
norimaki	のりまき
emanieltakashi	えまにえるたかし
kussun	くっすん
ekanoa	エカノア
sameko	さめこ
notosan	のとさん
miriha	みりは
hisaki	ひさき
micchan	みっちゃん
yasuroku	やすろく
mireraru	みれらる
perikanp	ペリカン
oka	おか
neko	ネコ
yurariro	ゆらりろ
sui	スイ
yasudayuko	やすだゆうこ
tarehuku	たれ福
kumo	蜘蛛
ginro	ぎんろ
umenori	梅海苔
rige	リゲ
aonekomochi	あおねこもち
tamaneko	たまねこ
erio	えりお
sabo	さぼ
honpo	ほんぽ
ponyorinko	ぽにょりんこ
yuki	ゆき
raika	ライカ
oinu	おいぬ
fiki san	フィキさん
aberagi	あべらぎ
tarako	たらこ
danbouru	段ボール
xotsuyu	夜露
hone san	ほねさん
yumitukaikuruto	弓使いクルト
menou	めのう
sabo	さぼ
hiyokkomame	ひよこ豆
nona	のな
omomo	おもも
nohohon	のほほん
aniki	アニキ
kurobuchi	クロブチ
yuru	ゆる
aya	あや
koyuki	こゆき
senma	せんま
roa	ロア
uguisu	鶯
monomane musume	モノマネむすめ
fumi	ふみ
irasutooukoku	イラスト王国
anmitsu	あんみつ
posan	ぽさん
asuka	飛鳥
fiki san	フィキさん
tsurimasamune	つり政宗
onoshi	おのし
wabisuke	わびすけ
naoki	なおき
kuroneko	くろねこ
yuzuha	柚葉
yuna	ゆな
kaorura	カオルラ
sakurazawariria	桜澤理莉愛
harukaw	はるか
yunohana	湯の花
shinon	シノン
urakawa mamoru	浦川まもる
runachi	るなち
yakisobakiraida	焼きそば嫌い
ume	うめ
ruda	ルダ
moyashi	もやし
atashidayo	あたしだょ
aro noze	あろノゼ
maya	マヤ
sujupon	すじゅぽん
nekohanten	猫飯店
sanocchi	さのっち
kabocha	かぼちゃ
ikuru	いくる
niura	弐浦
hiro	ヒロ
naota	なお汰
hitomi	ひとみ
yunase	ゆなせ
todooka	トドオカ
takuya	たくや
manamin	まなみん
heita	へぃた
mame	まめ
kuro	クロ
natsuya	なつや
toaru wotaku bito	とあるヲタクびと
soraran	そららん
kusanagiyakumo	草薙八雲
momoka	ももか
nana	なな
mochinori	もちのり
rikka	立夏
soraran	そららん
mofumofu	もふもふ
heynokappa	へのかっぱ
kunsamanu	くんさまぬ
chitose kumi	千歳組
ageha	あげは
nogi toshio	乃木トシオ
ito yamaneko	ｲﾄｳﾔﾏねこ
waka	わか
ada pon	アダぽん
chia	ちあ
kuroki	くろき
aniota akashi	アニオタ赤司
ahiruchan	あひるちゃん
chiapyoko	ちあぴょこ
yossan	よっさん
ikurachan	いくらﾁｬｧﾝ
rimano	りまの
kuma	クマ
aika	あいか
shiopan	しおぱん
akauma	赤馬
kobaiya	故買屋
ito	いと
maeda	まえだ
aika	あいか
togetoge	トゲトゲ
hoshino	ほしの
koyayan	こややん
koubokin	酵母菌
shinitage	虐げ
irukujira	イルクジラ
nagatsuki yuu	ながつきゆう
miura	みうら
bichan	びちゃん
mitamaori	みたまおり
shiki chan	しきちゃん
takucchi	たくっち
sayusayu	さゆさゆ
shirokuma	しろくま
runa	るな
hoheitokin	歩兵と金
ria	りあ
tanakaa	たなか
yamasaki	やまさき
chocobo	ちょこぼ
oyachi	オヤチ
aoto	青斗
donamochi	どなもち
ayano	あやの
shobunsha	晶文社
mizugi tan	水着たん
pietoro	ピエトロ
yuta	ユタ
umayoko	馬横
hippii	ひっぴー
mokoimo	もこいも
usagiame	うさぎ飴
ayubosu	あゆぼす
aere	アエレ
konomihime	このみひめ
hewachan	へわちゃん
hakataro	はかたろ
ryonyakunyannyo	ろうにゃくにゃんにょ
marirun	まりるん
achamo	あちゃも
fujiko	フジコ
ucchobi	うっちょび
minto	みんと
rabidonn	らびどん
suzuran	すずらん
mamo	まも
onigiri	おにぎり
tamachan	たまちゃん
renren	れんれん
hachimo	はちぃも
mimizuku	みみずく
shiroshiba	しろしば
umiushi	うみうし
ayaka	あやか
nada	ナダ
reika	れいか
radauta	ラダウタ
kiyo	きよ
harumo	はるも
mohisu	もヒ須
oon	おおん
hitohila	ひとひら
machisame	町雨
gomasho	ごましょう
kazuki	カズキ
reiya	れいや
shiatoro	しあとろ
kuma	くま
mo monga	ももんが
hakumai	白米
sekinko	せきんこ
hazuki	はづき
metappou	メタッポウ
yoshi futo	よしふと
mayata	マヤタ
vianka	ヴィアンカ
yuyu	ゆゆ
kagura mai	かぐらまい
hikina	ひきな
onakaitai	おなかいたい
daifuku	だいふく
haru	ハル
murakumo	ムラクモ
nishikakogawa	にしかこがわ
kemonar	けもなー
kobochii	こぼちー
yamanoouj	山の王子
kiseichan	規制ちゃん
fumisuke	ふみすけ
mugibatake	麦畑
sanada	真田
sora	そら
runo	るの
remi	れみ
showyan	しょうやん
mia	魅亜
okaki	おかき
makaminn	まかみん
ako	あこ
chiimama	ちーまま
yokkun	よっくん
inabaokimono	いなば置物
papiko	ぱぴこ
kazemar	風丸
sasukezaemon	サスケざえもん
kaede	かえで
wossan essan	ヲッサンヱッサン
batchan	ばっちゃん
kogoeshobo	小声書房
pyon	ぴょん
enon	えのん
hachirou	はちろう
tachikoma	タチコマ
nakahara	なかはら
karisa	かりさ
papiko	ぱぴこ
harunan	はるな
ryuu	りゅー
rabidonn	らびどん
umi tomato	海とまと
ryushan	りゅうしゃん
taihei	たいへい
negi	ねぎ
wasako	わさこ
yunamei	ユナメイ
savanna	さばんな
kajuen	果樹園
annirimochi	餡入りもち
kyosu mo	きょすも
papio	パピオ
rueru	ルエル
chomu suke	ちょむすけ
chage	ちゃげ
nao	なお
choko	チョコ
kuroko  basuke	黒子のバスケ
rena	れな
momogoro	ももごろう
yashidori	やしどり
homaruchan	ほまるちゃん
karasu	カラス
tsuki	ツキ
minto	みんと
iwasaki minami	岩崎みなみ
gurujin	ぐるじん
kasuyan	かすやん
hinata	ひなた
atsumin	あつみん
ruri	瑠璃
sunakawaumepi	砂川うめぴ
kuzukago	屑籠
furifurimomo	フリフリモモ
niikun	にいくん
torokon	とろこ
kingyo	金魚
abuzui	阿武瑞
rei	れい
rottoro	ろっとろ
karuraten	迦楼羅天
azutaku	あずたくん
chun	ちゅん
marunyan	まるにゃん
komatsuna	小松菜
kirimisakana	切身魚
purin	プリン
yukitora	ユキトラ
mendocorofujino	麺処ふじの
piyopiichan	ぴよぴいちゃん
himepon	ヒメポン
jujumotsu	じゅじゅもつ
ao ringo	青りんご
taetae	たえたえ
yotamaruu	よたまる
onisiki	鬼四季
kaito	かいと
gesoking	げそきんぐ
yakeisinimizu	焼け石に水
yama	やま
soipon	そいぽん
nijiberu	にじべル
erika	エリカ
himesaki  hana	姫咲はな
homuzuki	ほむずき
maru	マル
u	う
shiramochi	しらもち
kamakurapasta	鎌倉パスタ
fumipon	ふみぽん
takurou	たくろう
chanmari	ちゃんまり
sorairo	ソラいろ
chutohanpa	中途半端
aisama	あい様
arugon	あるごん
shingaputa	しんがぷーた
torimaru	鳥丸
radauta	ラダウタ
yosaku	よ作
yuki	雪
amurozumirei	アムロズミレイ
ougon nobuta	黄金のぶた
ando yuna	安堂ゆな
shun	しゅん
nazosatosi	謎サト氏
ume	うめ
fujihara	藤原
kouta	こうた
moneidou	モネイドウ
daidai	だいだい
ponpoko	ぽんぽこ
obake	おばけ
inundow	いぬん堂
sashimi	おさしみ
oyun	おゆん
yasusum	やすす
sasanagi	ささなぎ
ikuta ren	いくたれん
ramune	ラムネ
tomokichi	ともきち
jizeruchan	じぜるちゃん
ao	あお
nekopekko	ねこぺっこ
hakuten	はく天
ayanon	あやのん
michiya	みちや
juri	じゅり
shinonome karas	東雲カラス
aoi	あおい
yamepi	やめぴ
punyama pun pun	プン山プンプン
aruko	あるこ
gumi	グミ
suraa	スラア
coronpi	コロンぴ
biwaomochi	びわおもち
shiori	しおり
yamaken	やまけん
horigotatsu	ほりごたつ
triniku	とりにく
niseki	にせき
aokidekiseki	青黄でキセキ
mamegaracha	豆がら茶
miya	みや
mamecchi	まめっち
yonyon	よんよん
isasa	いささ
sakura maru	さくらまる
majiwata	まじわた
ritonorun	りとのるん
omiju	おみじゅ
tomoppe	ともっぺ
ami	亜実
yun	ゆん
neeyan	ねぇゃん
sakurak	さくら
nukaboko	ぬかぼこ
oshihe kantoku	おしへ監督
minomushi	みのむし
sako nnu	さこんぬ
hino	日野
someya chaya	染屋茶屋
saewata	冴えわた
ishinanao	いしななお
marukome otome	マルコメ乙女
koi	こい
miyabi chan	みやびちゃん
usagiotoko	うさぎおとこ
kanoe	かのえ
suzunari	すずなり
notewa	のてわ
maki	マキ
mamikimina	なみきみな
yukikimu	ゆききむ
pori peri	ポリペリ
osyaberi himura	おしゃべり火村
mai	まい
hinako	ひなこ
megadaibutsu	メガ大仏
nisikawa	にしかわ
koume	こうめ
kuusuke	くぅすけ
hekisa	ヘキサ
papipu	ぱぴぷ
irori	囲炉裏
ferinowaki	フェリの脇
yuuryou	ゆうりょう
okotatsudoragon	炬燵どらごん
tonbo	とんぼ
para	ぱら
gogonotenkiame	午後の天氣雨
haru	はる
umexemaru	うめぇまる
seto	せと
reiru	レイル
jugoyano usagi	十五夜の兎
haineko	灰猫
akiakiaki	あきあきあき
okka	おっか
sumiya	スミヤ
miso	みそ
chutohanpa	中途半端
nakomofu	なこもふ
yukemuri	ゆけむり
zirouamakusa	じろうあまくさ
meru	める
sunahamakujira	すなはまくじら
hamunemaboru	はむねまぼる
omiju	おみじゅ
epo	えぽ
rikubow	りくぼー
mikurineko ya	みくりねこ屋
kamakurapasta	鎌倉パスタ
shimafukurokouj	島袋小路
nukarume	ぬかるめ
tokage	とかげ
kuromu	くろむ
gajikov	がぢこ
pupu	ぷぷ
macchaura	まっちゃうら
hiroppi	ひろっぴ
aritayagi	ありたヤギ
tabattu	たばっツ
ajipon	味ぽん
hokosha	ほこうしゃ
ohanyoro chan	おはにょろちゃん
nekomata	ねこまた
miosame	澪鮫
kuromame	くろまめ
meimei	めいめい
ryonaga	りょーなが
anmanna	あんまんな
ottotto	おっとっと
yukochim	ゆこちむ
nayuho	なゆほ
rorimero	ロリメロ
tsumuji	つむじぃ
ikarashi	五十嵐
hiryouman	肥料マン
masa	まさ
kitaakari	きたあかり
arisaku	ありさく
kimutosyan	キムトシャン
hachi remo	はちれも
beta	べた
katutata	カツたた
moka	もか
taka	たか
haniwa	はにわ
nitagon	にたごん
mitsuki	みつき
mochippi	もちっぴ
fenia	ふぇにあ
amatsuda	あまつだ
hapihapitch	はぴはぴっち
chawaji	ちゃわ爺
mayamin	まやみ
ikuta ren	いくたれん
nekotetan	猫手たん
kaneyan	かねやん
tsuchio	ツチオ
mememe	めめめ
umichan	うみちゃん
k iritanpo	きりたんぽ
aeka	あえか
nogigino	のぎぎの
uen	うえん
taoru	たおる
seiyokumamire	性欲まみれ
tayu	たゆ
mashmaro	マシュ麻呂
iroha	いろは
roripan	ろりぱん
mitarashi	みたらし
shinkokyuuu	深呼吸
sikkarisikari	しっかりしかり
haya moko	はやもこ
mutou	無糖
natsume	ナツメ
meme	めめ
saitouyo	さいとうよう
pirorin	ピロりん
kika	キカ
kento	けんと
norision	のりしおん
yuuki sara	ゆうきさら
ibarausagi	茨兎
shima yuru	志摩ゆる
izayoi	十六夜
torinekomaro	とりねこまろ㌨
henohenomorita	へのへのもりた
kinnikun	きんに君
kabunoousyou	株の王将
suraa	スラア
miten	みてん
yuuhiromu	ゆうひろむ
emi	えみ
nyannko	にゃんこ
ryutaso	リュウたそ
oda	オダ
chiyarin	ちやりん
pana	ぱな
haruraku	はるらく
rubi usu	るびうす
kohalon	コハロン
ma saki	雅紀
maihime	舞姫
katuobushi	かつお武士
tori inko	鳥イン子
sekira ame	せきらあめ
chiba	ちば
yanagi kage	柳かげ
hamataro	はまたろう
rushiera	ルシエラ
katsudon	かつどん
oniisan	お兄さん
kukka	くっか
kaeruseijin	かえる星人
ajisai	あじさい
nekosennin	猫仙人
soa	ｿｱ
panorama	ぱのらま
fukashi	ふがし
totanpa	トタンパ
robomaru	ろぼ丸
megazarak	めがざら
mana	マナ
sakuramochi	さくらもち
sudaashiya	須田葦也
saorin	さおりん
susuch n	すすちん
nami	なみ
hunikoro	フニコロ
kujira	鯨
machopi	まちょぴ
kisara	きさら
utsusemi	空蝉
hossan	ほっさん
akitaku	あきたく
misono nanako	御園ななこ
yuukinoheya	ゆうきの部屋
necomori	ねこもり
gumimi	ぐみみ
aki	あき
gureifia	グレイフィア
natsupo	なつぽ
namakko	ナマコ
chibisawa	ちびさわ
retorosagasi	レトロさがし
koshaken	こしゃけん
rashin	らしん
sora	空
masuhiko	ますひこ
yuyu	ゆゆ
yasusuyasuyaaa	やすすやすや
oni cha	おにちゃ
yureme	ゆれめ
taka	たか
kaon	かおん
ypmizutamaneko	水玉猫
miyakotto	みやこっと
sayuyun	さゆゆん
teruteru	てるてる
emimiura	エミミウラ
aaaa	ああああ
edda	エッダ
azarasi shachi	あざらしシャチ
yuno in	ゆのいん
kanipasuta	かにぱすた
kuruton	くるとん
yuu	ユウ
myuui	みゅーい
min	みん
asato	朝斗
tsukumo	つくも
e bidaisuki	エビ大好き
akita	あきた
hikarun	ひかる
oshida	押田
akutozen	悪ト善
izuku	いずく
kumiko	クミコ
ponyodora	ぽにょどら
bouningen	棒人間
hanashiawanai	はなしあわない
ichiru	いちる
hitthun	ひっちゅん
mogumogukun	もぐもぐ君
kotobukiman	コトブキマン
sanso	酸素
yasapen	やさぺん
wataame	わたあめ
fuwafuwanokuma	ふわふわのくま
no chan	のっちゃん
endoujun	遠藤潤
chiesha neko	知恵捨猫
hanon	はのん
kimayun	きまゆん
uka	うか
karua	かるあ
toyo ne	とよね
sujiniku	すじにく
neo	ネオ
kichisuke	きちすけ
kirin mintama	きりんみんたま
hirodai	ひろだい
yamazatou	山砂糖
urawa	うらわ
hakutakagou	はくたか号
u enohara	上ノ原
sera maru	せらまる
youseisan	妖精さん
sakusaku handa	さくさく半田
urawazakun	裏技君
yonoki	よのき
subaru	昴
kanata	カナタ
kuro	クロ
koke yan	こけやん
yamazakimiho	やまざきみほ
hakuenfuki	白煙吹き
shi marisu	しまリす
same	さめ
pisu	ぴす
aozora	青空
saku	さく
manoreo	マノレオ
nyakochi	にゃこち
maiyanguu	まいーやんぐぅ
takenokoyaroo	たけのこ野郎
tomatto	とまと
barusu	ばるす
takahiro	タカヒロ
ame	あめ
dai sharin	大車輪
yokochi	よこち
shiraueyuu	白上遊
sichimikuroneko	しちみ黒猫
arai	アライ
honpokeca	ほんポケカ
riseru	リセル
riru ko	りる子
onotaku	おのたく
nemumi posse	ネムミポッセ
yasa kita	やさきた
non	のん
pandaman	パンダマン
hiyayakko	ひややっこ
debutonko	デーブとん子
huwamaru	ふわまる
yuihan	ゆいはん
kurihuji	栗藤
coronazo	ころなぞ
a tsuhiko	あつひこ
makkuri	まっくり
ikaokura	いかおくら
junboku san	純朴さん
erina	えりな
mikomama	みこママ
chan kuro	ちゃんくろ
furifurimomo	フリフリモモ
matsuru	まつる
karmajiro	かるまじろ
maro	まろ
ayaka hime	あやか姫
satsuki	さつき
emerarud	エメラルド
tanashou	たなしょう
fujisan	ふじさん
yodamomo	与田もも
yupu	ゆぷ
sabaneko	鯖猫
oishi imo	おいしいいも
ma ruru	まるる
aika	アイカ
abechannchi	あべちゃんち
repi	れぴ
miyatake	ミヤタケ
shinji	しんじ
teide kei	テイデケイ
yorori	よろり
zakkorin	ざっこりん
poko	ぽこ
kui	杭
teraonn	テラオン
fujijun	ふじじゅん
tae chin	たえちん
limuyasu	りむやす
samidare	さみだれ
nukatuhi	ぬかつひ
asapi	アサぴ
kagemarukun	かげまる君
suzu	すず
zakuro	柘榴
tsubantos	つばんトス
tessan	てっさん
fusu	ふす
yuzu	ゆず
huwamaru	ふわまる
naranoneko	奈良のねこ
hayate kanako	はやてかなこ
siroriyu	しろりゆ
nekotasu	ねこたす
fujisan	ふじさん
masutch	マスッチ
nana	なな
inano	いなの
kisimotokarasu	岸本烏
hikage	ひかげ
vanvaiyoshioka	ヴァンヴァイ吉岡
ayunico	あゆにこ
sei	セイ
azukimametaro	あずき豆たろう
sayumi	さゆみ
ramune	らむね
nakabon	なかぼん
maruiyama	まるやま
fumipon	ふみぽん
yoasobi	よあそび
shokoraa	ショコラ
hokoinu	ホコ戌
haruru	はるる
satoha	サトハ
jinseikudaranai	人生くだらない
homokise	ホモ黄瀬
kasanosuke	かさのすけ
marumiyakun	まるみやくん
omote	おもて
asamon	アサモン
rukasenyo	るか専用
ishi	いし
komugiko musuko	小麦粉の息子
mayuzu mi	黛
hanashiawanai	はなしあわない
heppoko	へっぽこ
yuzuha	ユズハ
inari	いなり
nobou	のぼう
chirishonen	地理少年
mokusyun	もくしゅん
gansobesshoman	がんそべっしょマン
shikimi	しきみ
amagi	天城
ikke	いっけ
nopufi	ノプふぃ
kuma	くま
azumine	あずみね
yukimushi	ゆきむし
sakuramochi	さくらもち
ankirum	アンキルム
oki mamiya	沖麻実也
puchico	ぷちこ
nemurizaka	眠り坂
nan	なん
amatsuda	あまつだ
riopi	リオピ
hin	ひん
negitoro oishi	ネギトロおいしい
kai	かい
fukuha	ふくは
gumita so	ぐみたソ
kikochan	きこちゃん
fuzuki tajiwo	文月タジヲ
hoshinasu	ほしなす
mikage sousaku	みかげそーさく
hagecyabin	はげちゃびん
ryoichi	リョウイチ
masapyon	まさぴょん
ittemitaina	行ってみたいな
nobuyumi	のぶゆみ
yamazatou	山砂糖
mori mori	もりもり
ako	あこ
betafujihara	ベタ藤原
sensen	せんせん
miya	みや
reito	玲斗
yuusukeq	ユウスケ
yato	ヤト
nitatuyama	ニタツヤマ
masarakki	まさらっき
poyopoyochan	ぽよぽよちゃん
toaru wotaku bito	とあるヲタクびと
kokatorisu	コカトリス
amemaro	アメマロ
omaru	おまる
rizu	りず
chibu	チブ
kamechanita	かめちゃにーた
nonchun	のんちゅん
kyontarou	きょんたろう
neko	ネコ
tama ani	タマ兄
yukako	ユカコ
yukisan	ゆきさん
sukechasu	すけちゃす
iori	伊織
mun	むん
furau bou	フラウ坊
riri	りり
kanakeke	かなけけ
hatosabu	はとさぶ
miyabi	みやび
mashitonodesu	ましとのです
inagakiyasuto	イナガキヤスト
hassaku	はっさく
yato	やト
kopio	こぴお
sui	翠
kama iruka	かまいるか
nagomi	なごみ
mochimochiichi	もちもちいちご
tsukino miyako	月野みやこ
arixmura	有村
suigin	水銀
kaijinshoukai	怪人商会
yawakonuiguru	やわこぬいぐる
ajiwai	あじわい
gyaosu	ギャオス
emmachii	エマちぃ
kozueyuki	梢友紀
shirikoba	しりこば
okikoebi	沖コエビ
ruri	瑠璃
onisan	おにさん
mizusyo	みずしょ
unoukun	右脳くん
natsu ko	なつこ
koro	ころ
mandaring	まんだ林檎
gureifia	グレイフィア
barepon	バレぽん
ujiko	うじこ
kaitoma	かいとま
hitokovrakuda	ひとこぶらくだ
iikochi	いいこち
pirika	ぴりか
ekusupuroidar	エクスプロイダー
mimurokku	みむろっく
runa	ルナ
hiroking	ひろきん
moru	もる
mutoumei	無透明
tayatakan	たやたか
takamipo	タカミポ
maiyanguu	まいーやんぐぅ
hiyoyon	ひよよん
gomukesi	ゴムケシ
totoki suyu	とときすゆ
ishiyumi	石弓
nakato	なかと
nayurun	なゆる
ikekubo	いけくぼ
gamaguchi	がまぐち
mikuroup	ミクロウ
nabe	なべ
tamasiro	たましろ
chimuran	ちむらん
joringo	じょりんご
yomosan	よもさん
marumariko	マルまりこ
yasaka	八坂
yokamo	よかも
yaabon	やぁぼん
moshamaru	もしゃ丸
nunanun	ぬなぬ
gaako	がぁこ
akane	あかね
mitukan	ミツカン
awagome	あわごめ
akaringo	あかりんご
pinoko	ぴのこ
monstoro	モンストロ
shin	シン
ribbonko	りぼん子
kamakurapasta	鎌倉パスタ
azuki	あずき
antsubu	あんつぶ
yuyu ta	ゆゆた
simizuhomo	清水ホモ
touka	トウカ
mizu	ミズ
mino shi	みの氏
otamakana	おたまかな
okaki	おかき
mamachari	ママチャリ
mika	ミカ
mushimaru kun	蟲丸くん
risokinero	リゾ木ネロ
yoshizo	よしぞー
tomii pepe	とみいぺぺ
beyan	べやん
nagataku	ながたく
meibisu	メイビス
kimagureneko	気まぐれ猫
usui	碓氷
akebi kainushi	あけび飼い主
hinori	ひのり
reiannzu	玲杏
shiorin	ｼｵﾘ
kuu	くー
fuuko	ふぅこ
yoda mochi	よだもち
mie	みえ
gochiame	ごちアメ
shirosuna sisu	白砂シス
uru	うる
mugi	むぎ
kamaseinu kun	かませ犬くん
sando	さんど
chakochan	チャコちゃん
macha	まちゃ
kamakurapasta	鎌倉パスタ
tamabiii	たまびー
miyahae	ﾐﾔﾊｴ
yuu	ゆう
maruno	まるの
mokusei	木星
ponyodora	ぽにょどら
takajyura	たかじゅら
nekomamirenoora	猫まみれのおら
nana	なな
maria	マリア
kosuke	こすけ
ringo	りんご
nemu	ねむ
ktorisasami	とりささみ
roa	ろあ
fujinari	ふじなり
rogu	ログ
chirumasu	チルマス
sayumo	さゆも
mitori	みとり
sanasanasan	さなさなさん
gyotaku	魚拓
sironeko	しろねこ
mizukishorin	みずき書林
kurihuji	栗藤
penmaru	ペン丸
minarai	みならい
tonmii	とんみぃ
comanchi	コマンチ
papiyon	ぱぴよん
ryosuke	りょうすけ
neko pura	猫プラ
michi	みち
natumikan	なつみかん
midori	みどり
kikiu	ききう
oyuisan	おゆイさん
uraken	うらけん
puke	ぷけ
chokusan	ちょくさん
umeda hibari	梅田ヒバリ
yuzu	ゆず
kinpira	キンピラ
fittones	フィットネス
fumia	フミア
chobizo	チョビゾウ
kamimo ri	かみもり
erika	えりか
sorano	そらの
rei	れい
konqota	こんぽた
miwa	みわ
eko	えこ
takesyan	たけしゃん
sakuraebi	桜えび
ribbonko	りぼん子
pote maru	ぽてまる
yura	ゆら
jagatuma	じゃがつま
chizu ya	地図屋
hanakokun	花子くん
yurizosta	ゆりぞすた
sabuchan	さぶちゃん
udonshi	うどん史
osamura	オサムラ
wara	わら
mokona	モコナ
matsurinka	まつりんか
sukebe na umaso	すけべなうまそ
riri	りり
zouri	ゾウリ
mamegohan	豆御飯
wokome	ヲ米
toyuki	とゆき
byakuya	びゃくやん
natsuo	なつお
satokun	さとうくん
meacha	めあちゃ
kitagami	きたがみ
nuntaro kun	ぬんたろくん
soramiko	ソラミコ
kigatarei	きがたれい
hana	はな
odorena	おどれな
kohaku	琥珀
hagayui	はがゆい
kanyapi	かにゃぴ
piolimu	ぴおりむ
tomoichi	ともいち
nanase	七瀬
takamaki	タカマキ
sato kaoru	佐藤馨
kai rai	傀儡
chachan	ちゃちゃん
nakano junji	なかのじゅんじ
poponpgunyan	ぽぽんぷぐにゃん
shikachu	しかちゅー
asakukun	策くん
asayan	あさやん
kuwataro	くわたろ
mii	みい
hirari	ひらり
masamipyon	まさみぴょん
ameri	あめり
sawawano	さわわーの
ueiru	うえいる
fukuoka noinu	福岡のいぬ
china kae	ちなかえ
makoyanra	まこやんら
nagatsukip	ながつき
eramayone	えらマヨ姐
yandere terumi	ヤンデレ照美
nao mikepo	なおミケポ
sacchan	さっちゃん
xrekkusu	れっくす
kyouten	狂天
neoyamah	ねおやま
piyoko	ぴよこ
kaku san	かくさん
usaka	うさか
katsumi	かつみ
garururou	ガルル郎
minawasiro	みなわしろ
kuri kato	くりかと
datto	脱兎
hehe moetarou	へへ燃え太郎
emo	えも
anyopin	あんよピン
momon	ももん
shiaha	シアハ
ponke	ポンケ
gajua	がじゅあ
yassan	やっさん
sora	そら
hajime	はじめ
konnyakugou	こんにゃく号
rettrin	れっとりん
kuriyou kan	栗羊羹
poyo	ぽょ
magokoro	まごころ
sayasuke	サヤスケ
piyorun	ぴよる
rona	ろな
shitoreme	しとれめ
kaito	快斗
miroku	弥勒
jisonshin	自尊心
yuuka	ゆうか
kuroko	黒子
chururu	ちゅーる
macha oji	まちゃおじ
ree	れー
misaki	みさき
soato	そあと
ran poko	らんぽこ
yukari	ゆかり
sapi	さぴ
mii maro	みーまろ
enameringz	えなめりんぐ
nagaok arimiya	長岡りみや
shihorin	しほり
unipo	うにぽ
asondekun	あそんでくん
futaba ayanami	双葉綾波
nukadoko	ぬかどこ
onburu	オンブル
misaya	ミサヤ
yuuri	ゆうり
mochi mochi	もちもち
uko chan	うこちゃん
sentakuneco	せんたくねこ
nao	なお
ree	れー
uwasanokami	噂の紙
tozamasan	とざまさん
necodamashi	ねこだまし
kashiwa	かしわ
norahrikurahri	ノラリクラリ
inupanchi	イヌパンチ
uranansakaba	ウラなん酒場
remu	れむ
shirochi	しろち
domingo	ドミンゴ
kiraring	きらりんぐ
hinamaru	ひなマル
narutae	なるたえ
piroru	ぴろる
kuroko	黒子
wato	わと
fuuchan	ふうちゃん
erena	えれな
mahiru	まひる
kama	かま
harupiyo	はるぴよ
no name	のなめ
meru nna	めるんな
zaki	ザキ
asahi	朝飛
yuuma	ゆうま
kamo	かも
moyashi	もや氏
purinsan	プリンさん
airi	あいり
genzaisuiryo	現在推量
chikka	ちっか
kaworun	かをるん
surei	スレイ
poponoosu	ポッポのオス
sunaku	スナク
ruto	ると
kako	かこ
tanukisoba	たぬきそば
niiko	ニイコ
nezutaso	ねずたそ
sazanami	さざなみ
petarex	ぺたれ
shizuma	しずま
oama	おあま
serizawa	芹沢
pendora	ぺんどらー
miyuo	ミユオ
osobachan	おそばちゃん
kaatan	カータン
ayano	アヤノ
kurari	くらり
kiyuki	きゆき
norina	のりな
warugakki	悪餓鬼
sayachan	さやちゃん
hagecyabin	はげちゃびん
mattan	まったん
makoumu	マコウム
nagiserori	なぎせろりん
kaeru	かえる
ginji	ギンジ
momo	もも
yukimi	ゆきみ
jironikii	じろﾆｷ
oyun	おゆん
motchiri manju	もっちり饅頭
coronpi	コロンぴ
kiara	キアラ
taichinn	たいちん
yume	ユメ
sayaka	さやか
sinonome	東雲
shoutaro	将太郎
yukkurugaya	ゆっくるがや
aki	あき
yuma	ゆま
gahaha	がはは
soramame	そらマメ
bukiyouchan	不器用ちゃん
hibino	日々野
yuuto	悠斗
dededede	デデデデ
tadanohimazin	ただの暇人
potepokari	ポテポカリ
matsushimayurur	松嶋ゆるり
jhaiokumantan	廃屋満タン
neyu	ねゆ
yureru	揺れる
shingishi	新岸
shinjoh	新条
fusumakunn	ふすま君
kageotoko	影男
ponyodora	ぽにょどら
kiarann	キアラン
minmin	みんみん
soato	そあと
kikka	橘花
wapa	わぱ
maikun	マイ君
kuranku	クランク
usat amu	うさたむ
misanbo	みさんぼ
yuma	ゅま
kagu ra	神楽
rin	りん
arakidonsan	あらきどんさん
kitainkya	北院きや
rui	るい
yugi	ゆぎ
nuuchi	ぬぅち
toki	とき
shon maru	しょんまる
manpuku	まんぷく
yuramin	ゆらみん
inemurimajin	居眠り魔神
amarunn	アマルン
annu	あんぬ
nanachi	ななちょ
ruino	るいの
sakuramochi	桜餅
uki tomomi	雨季朋美
kanami	かなみ
sa yama	サヤマ
kiichi	きいち
ikachan	いかちゃん
taro	たろ
masa yume	まさゆめ
shizu	しず
shon maru	しょんまる
oshi yun	おしゆん
tunakan	ツナ缶
koranda	コランダ
takuto	タクト
niente	にえんて
nozue	ノズエ
nanaonao	ななおなお
tsubu an	つぶあん
shunshuno	しゅんしゅんお
kurou	クロウ
gion	ぎおん
sunapua	すなぷあ
tomonori	トモノリ
emu	えむ
dakumuu	だくむう
sasuke	さすけ
mekkyoso	めっきょそ
merumo	めるも
mono	もの
roteri	ろてり
nagaimaru	ながいまる
nomopi	のもぴ
yuutokii	ゆうとき
chicome	ちこめ
hari	針
tani koshi	たにこし
sasami	ささみ
akatuki	暁
fujisan	藤さん
chiichasoo	ちぃちゃそ
haru	ハル
kyaruko	きゃる子
rorikonnkakka	ロリコン閣下
imo	芋
yumemakura	夢まくら
shitori	シトリ
tamuvia	タムビア
kuri kato	くりかと
nomeji	のめじ
hotatechoco	ほたてちょこ
usanoha	うさのは
rei namu	れいなむ
kuromana	くろまな
keke	ケケ
penko	ペン子
matsuri	祭
saoming	さおみん
jaruo	ジャルオ
hiratai	ひらたい
nekoking	ねこキング
shirura	しるら
moai	モアイ
yoshiko	淑子
suzuto	鈴斗
sashimi	さしみ
kazamaron	かざまろ
kuuusuke	くーすけ
usat amu	うさたむ
mari	まり
kasumin	かすみん
tansanx	たんさん
amagumohebi	雨雲蛇
okita	おきた
guya	ぐや
toriinu	とりいぬ
mamikimina	なみきみな
reinadon	れいなどん
inaho	いなほ
matsunoha	まつのは
asari	あさり
yuyumeme	ゆゆめめ
hana	はな
hau ndo	ハウンド
ga suke	がぁすけ
akatuki	暁
oimochan	おいもちゃん
dosha ko	ドシャ子
kakerine	カケリネ
chinsan	ちんさん
nanasikun	ななしくん
ushimaru	うし丸
uyuchanhonpo	ぅゅちゃんほんぽ
bunkeisyoku	文系色
kahorin	かほりん
tenchi nchin	天地んちん
denden	でんでん
jihou neko	時報ねこ
hisui	ヒスイ
tomocho	ももちょ
coshiji	こしじ
kisomitake	きそみたけ
vaara	ヴァーラ
kuma	くま
ron	ろん
masaki	まさき
nekokane	ねこかね
shioshio	シオシオ
hatsukona	はつこな
suzkikenta	鈴木健太
funya unya	ふにゃうにゃ
matsu	まつ
nao	なお
monyu soku	もにゅ速
ukokkei	うこっけい
koha	こは
porepore mamma	ぽれぽれマンマ
uta	ウタ
macha oji	まちゃおじ
nattoman	なっとマン
shokora	ショコラ
maria	マリア
matsuyoshi	まつよし
suruga	するが
yonnnana	よんなな
izonmozi	依存文字
sansotento	酸素テント
maron	まろん
sagaruya	さがるや
norina	のりな
joe	じょえ
remu	れむ
ryoukun	りょーくん
yue	ゆえ
sakako	サカコ
hima tokage	ひまとかげ
hanatama	はなたま
rura	ルラ
unoko	うのこ
puraneto	プラネット
hiko	ひこ
nakaba	なかば
tarou	たろう
chisa	ちさ
ehayate	はやて
yuki	ユキ
inupanchi	イヌパンチ
tatahai	たた牌
ginko	銀子
kotono	琴乃
bokutakubo	ぼくたくぼ
haribote	ハリんぼて
satasat	サタサタ
rura	ルラ
takana	たかな
sagamik	さがみこ
mikango	みかん号
ohisamawanko	おひさまわんこ
kururu	くるる
yun	ゆん
noro usa	のろうさ
fujino	藤乃
kawami nami	かわみなみ
aramata	あらまた
kinose	木ノ瀬
otogi	御伽
yomogi	よもぎ
raito	らいと
yagi	やぎ
shiromak	しろまく
fujiemon	藤衛門
tan chan	たんちゃん
papipapipuppu	ぱぴぱぴぷっぷ
yuukarin	ゆうかりん
rani	ラニ
rakutoku	楽とく
meruviru	メルヴィル
futori	ふとり
wakabanana	わかはなな
mogaru	もがる
kirishima	キリシマ
fu	芙
yosuga	よすが
botamochi	ボタモチ
pino	ぴの
hoshi	星
dedededede	ででででで
momoiro	モモいろ
bira pon	びらぽん
konohairoha	このはいろは
yoshijirou	よしじろう
yukinko	ゆきんこ
kamitonotaiwa	神との対話
amaoto myako	雨音みゃこ
kirishima	キリシマ
nanase	ななせ
aruto	アルト
yukinko	ゆきんこ
sumidoran	すみどら
wakayosii	わかよし
niente	にえんて
yuuna	ゆーな
hariusagy	針兎
fajiarunyu	ふぁじあるにゅ
yamato e	やまとえ
tenchi nchin	天地んちん
ruriha	ﾙﾘﾊ
koruku	こるく
narusui	なる酢
ikuyumu	いくゆむ
mana	まな
suzumev	すずめ
gomaruna	ごまるな
inuki yuko	戌木ゆ子
minirei	みにれい
takapuchun	たかぷぅちゅん
kithuki	杵築
nekotoawadama	ねことあわだま
naruki	なるき
ugorin	うご凛
oryou	おりょう
ungen	うんげん
sanocchi	さのっち
yuzurinngo	ゆずりんご
imami	いまみ
haruuxe	ハルウェ
mei	メイ
kahara	かはら
yumiso	ゆみそ
maaobasan	マーおばさん
nefue	寝笛
yuchamaru	ゆちゃまる
mo tama	もーたま
daibou	大坊
maria	まりあ
bokeboke	ボケボケ
shoudai	しょーだい
raura	ラウラ
kanta	かんた
bashi	バシ
vii dai	ヴィー大
matatabi	またたび
mujirushi	無印
humitukisesuka	ふみつきせすか
hiironn	ひいろん
muku	ムク
ebikani kirai	エビカニ嫌い
shiki	シキ
kazutaka	かずたか
yasuto	やすと
satochin	さとちー
koppyan	こっぴゃん
tamakon	たまこん
nanami	ななみ
zyukoibaruchan	呪恋ばるちゃん
umauma	うまうま
kuma	くま
nagisa	なぎさ
mashiron	ましろ
heitaku	へいたく
keita	ケイタ
mikageaki	御影アキ
mikango	みかん号
jhaiokumantan	廃屋満タン
gomamoge cha	ごまもげちゃ
shirosuzu	しろすず
asua	あすあ
yozakura iroha	夜桜いろは
motchi	もっち
ikkun	いっくん
hanisto	はにすと
tanso	炭素
koromo	ころも
potutake	ぽつたけ
yamamoto	やまもと
kurodokei	黒時計
nukesaku	ぬけさく
hamachan	ハマちゃん
ajarimonta	あじゃりもんた
takanami	たかなみ
fate	ふぁて
nekokan	ねこかん
suzune	すずね
takegola	タケゴラ
nemusuke	ねむすけ
rakkyoumiso	らっきょう味噌
kinakomochi	きなこ餅
azu	アズ
sabanomisoni	サバの味噌煮
pipu	ぴぷ
marumichan	まるみちゃん
tomoichi	ともいち
maho	まほ
moromi	醪
hiroron	ヒロロン
masarun	まさるん
ukigumotei	浮雲亭
hanada	はなだ
otsuko	おつこ
humitukisesuka	ふみつきせすか
beko	べこ
kiritore	きりとれ
pengin	ぺんぎん
kurozakura	黒桜
rei	レイ
sakurai yuki	櫻井由希
wataberu	わたべる
anko mochi	あんこもち
animeanteiku	アニメあんていく
ebichiri	エビチリ
megazakro	メガザクロ
soruto	そると
nishikaze yuki	西風優希
nanane	ななね
otaku n	オタクーン
yamamaru	やままる
lonisaka	ロニ坂
ayanon	あやのん
soa chan	そぁちゃん
nemuta	ねむた
ogurin	おぐりん
inabaoden	因幡おでん
mon	もん
konamelon	こなめろん
pite	ピテ
rokujohitoma	ロクジョーヒトマ
poshi	ぽし
pobeyama	ぽべ山
taneatsu	タネアツ
suzune	すずね
zono	ぞの
nishiyama	西山
okusamansa	奥様んさ
uosuke	うおすけ
yotuhiko	ヨツヒコ
mimiyo	みみよ
sirokuma	しろくま
kuroharu	クロはる
nomizuiori	野水伊織
namio	なみお
yuri	ゆり
riria	りりあ
rikka	立夏
yuimaruseitai	ゆいまーる整体
isudzumi	いすづみ
hokke taso	ほっけﾀｿ
keika	けいか
mina	みな
ianeko	いあ猫
konnoran	紺野ラン
yuzuriha honamin	ゆずりはほなみん
yuyuyu	ゆゆゆ
kouki	コウキ
fromiko	風呂巫女
ro puru	ろっぷる
nano yuka	なのゆか
hadukikei	葉月ケイ
hikaru	ひかる
sendai	せんだい
teringo	てりんご
natayumi	鉈弓
toinosuke	といのすけ
makeo	まけお
maru	まる
gimei	偽名
ma chan	まあちゃん
riichi	りいち
nonrin	のんりん
tana ka	田中
kanaetai	叶え隊
tsuru	鶴
nemineko	ねみねこ
dorandoran	どらんどらん
momochimomo	ももちもも
nannekosan	なんねこさん
matsuko	まつ子
yukimi	雪見
rimoune	リモーね
satomi	さとみ
mikonosu	ミコノス
sanpo	さんぽ
yuzumin	ゆずみん
yuugata	夕方
tomomi	ともみ
rakuten	楽天
itsuki	イツキ
eharadaisuke	江原大介
hanachan	はなちゃんー
moemi	もえみ
kyuuri	キュウリ
sekiyaoniyome	関谷鬼嫁
saji	沙慈
momochimomo	ももちもも
yakii moko	やきいもこ
kitakoma	キタコマ
yuri	ゆり
takimoto	たきもと
aoba	青葉
cheripoyo	ちぇりぽょ
toki	鴇
tatsuhiro	タツヒロ
ren	れん
mashimaro	ましまろ
nano yuka	なのゆか
hamatani	濱谷
yutokei	湯時計
sasage age	ささげあげ
yamashiro	山城
kuuhuku	くうふく
nanase	ななせ
mori yosougai	もりよそうがい
miyuemon	みゆえもん
wao	わお
kindoru faibar	キンドルファイバー
rairamiramiura	ライラミラミウラ
naiden	ないでん
manoru	マノル
hyamio	ヒャミオ
ogyaiku	オギャイク
matsunoumi	まつのうみ
shinmokkun	シンもっくん
kuusatsuaki	空撮あき
akasa	あかさ
pime	ぴめ
nayama	なやま
hirari	ひらり
charo	ちゃろ
mukarei	むかれい
kanchobi	かんちょび
ayako	アヤコ
hicagechan	ひかげちゃん
mei	めい
sechi	せち
seiryu majin	青龍魔神
kaori	かおり
rannosuke	らんのすけ
tomoko	とも子
nevin	ネヴィン
sanamaru	さなまる
akadaama	赤玉
ranobe	らのべ
shironku	しろんく
kimuchiizunabe	キムチズ鍋
kurage	海月
tomaranbou	とまらん棒
yamazak	山崎
mimiumi	耳海
rikakochama	りかこちゃま
arutedon	あるてどん
takkun	たっくん
matsume	まつめ
tobirou	とびろう
mamarif	ままり
kaeruman	かえるまん
noi	のい
anjerine	アンジェリネ
daraku	駄楽
soukai	ソウカイ
reo	レオ
chanbo	ちゃんぼ
inu	いぬ
yurinotomo	百合の友
yamashin	やましん
delorumin	でろるみん
kurokumanidaime	黒熊二代目
miyakoo	ミヤコ
yukinyanko	ゆきにゃんこ
tocochin	とこちん
adusagou	あづさ号
chihare	ちはれ
kakiihiro	柿井ヒロ
akino suzume	秋野すずめ
nekoma	ねこま
amamizu	雨水
rokio	ろきお
makabe shun	真壁俊
nana	なな
shimiken	しみけん
sutekinamiraie	素敵な未来へ
shigure	しぐれん
mashira	ましろ
youhei	洋平
hekihara	碧原
popotannogeboku	ぽぽたんの下僕
iichiko	いいちこ
omu	おむ
sakura	さくら
raku	ラク
shiragiku	白菊
koharin	こはりん
kuru	くる
otakaradouga	おたからどうが
ryumika	リュウミカ
gensan	げんさん
towa	とわ
ereusu	エレウス
yamashin	やましん
kuro taisa	くろたいさ
shironku	しろんく
mqkkuma	マックマ
ikesaki	いけさき
rinatsun	りなつん
kaminage	紙投げ
kame	カメ
maruchan	まるちゃん
aka mimi	アカミミ
yomomon	よもも
nohama	のはま
umino tantan	海野たんたん
takosensei	タコ先生
akira	あきら
haruko	はるこ
kikusuke	きくすけ
nanamaru	那奈丸
tachiuo kai	タチウオ改
kidaruma	きだるま
kyohneko	京猫
saracchi	さらっち
usabele	ウサべぇ
aoi	あおい
ren	廉
watanasi	わた梨
nakinokaeru	哭きの蛙
miyao	みやお
achan	ｱﾁｬﾝ
hiromu	ひろむ
chiida	ちいだ
kito	きと
shiroarikuina	白蟻くいな
pani	ぱに
riruriru	りるりる
hakaranya	はからん屋
okyana	おきゃな
shenruka	シェンルカ
gomichu	ごみちゅう
kusa	草
shirayurihome	白百合ホーム
taka	たか
karu	カル
rikanojikan	理科の時間
fuwafuwanokuma	ふわふわのくま
mochineko	もちねこ
hasamaru sabu	はさまるサブ
ayanon	あやのん
yu suke	ゆーすけ
takayan	たかやん
paisen	パイセン
koashi	こあし
ouchi  kaeritai	おうちかえりたい
inagakiyasuto	イナガキヤスト
misoteika	みそていか
remu	れむ
tetsuro	テツロー
airi	あいり
asato	朝斗
hiro	ひろ
akaimajin	あかいまじん
rinngofunifuni	林檎ふにふに
asuparagasutaro	アスパラガス太郎
shima roba	シマロバ
yamaneko	やまねこ
retsuya reka	烈弥れか
nishinchan	にしんちゃん
orijin	おりじん
wataame	わたあめ
akuenaten	アクエンアテン
aegukano	喘ぐカノ
hakonohunotori	函野富の鳥
raion	らいおん
oekakigolira	お絵かきゴリラ
pukupuk	ぷくぷく
uedaya	うえだ屋
tomo ruru	トモるる
yosaku	与作
rinyoran	りにょらん
masuru hasun	まするはすん
koza	こざ
kaomoji matome	顔文字まとめ
micchan	みっちゃん
masashi	まーし
opatsuko	ぱつこ
masamune	マサムネ
yuriaaaa	ゆりああああ
soyokazegoh	そよかぜ号
soujirou	そうじろ
mimizuku	ミミズク
tomocho	ももちょ
ban machi	番町
maukeru	まうける
sake	さけ
hiroimu	ヒロイム
shirulega	しるれが
rena	れな
onryu	おんりゅ
nirugiri	にるぎり
kingyo	金魚
hayaken	はやけん
orikage	おりかげ
serenankotu	セレ軟骨
tomo	とも
kanariko	かなりこ
peraimaru	ぺらい丸
kuroniji	黒虹
maniwaumigame	真庭海亀
gyunto	ギュント
ko suke	こーすけ
kari mizu	かりみず
sakura	さくら
kamakurapasta	鎌倉パスタ
tougen kyou	桃源キョウ
onemuchan	おねむちゃん
kazunoko	かずのこ
shiro maro	しろまろ
natumikan	なつみかん
sette	セッテ
daichi	だいち
kamikou	かみこー
hamukatuko	はむかつ子
chiba	ちば
yuriia	ゆりいあ
harumagedon	はるまげ堂
tomoka	ともか
akioji	あきおじ
chihaze	ちはぜ
iguana	イグアナ
mio	みお
sudaashiya	須田葦也
nipa	にぱ
anehime	あねひめ
kometogibabaa	米とぎばばあ
paburi	ぱぶり
koume	小梅
kanso kurumi	乾燥クルミ
surari	すらり
itoyobunko	イトヨ文庫
mokku	モック
yuheri	ゆへり
masamipyon	まさみぴょん
ginro	ぎんろ
takumaru	たくまる
anchobizamurai	アンチョビザムライ
esuto	エスト
monmon	もんもん
asami	浅見
shagami	しゃがみ
mokkaseiya	モッカセイヤ
takami runa	たかみるな
shintanimayumi	新谷真弓
tamu	たむ
kanade	かなで
misumaru	みすまる
littorio	りっとりお
osamuchin	おさむちん
ninchyomo	にんちょも
hoshinome	ホシノメ
benzenetan	ベンゼンたん
hanamiya	はなみや
shitorera	シトレラ
yura	ユラ
hachi	ハチ
niwaka	ニワカ
fumu	ふむ
ichinose maria	一ノ瀬まりあ
muku	椋
heppoko marie	ヘッポコまりえ
nannonanigashi	何の何某
tetsu	てつ
yupi	ゆぴ
moka	もか
riru ko	りる子
kobayan	こばやん
i magawa	いまがわ
himagine	ヒマギネ
hirudoa	ひるどあ
nikuchan	にくちゃん
mamikimina	なみきみな
shichun	しぃちゅん
yuka	ゆか
raamentaro	らあめん太郎
koiakane	恋茜
nubuchan	ぬぶちゃん
sirayukikun	白雪くん
ankokuou	暗黒王
shouta	翔汰
maroi	まろい
mipoliina	ミポリーナ
uniru	うにる
nika	ニカ
meronpan	メロンパン
akaringo	あかりんご
irotsuka	いろつか
ringo	りんご
sakurak	さくら
samidare	さみだれ
nakamin	なかみん
himousya	ヒモウシャ
bamuruta	バムルータ
takajin	タカジン
fujimoranai	フジモらない
hiyokonbu	ひよこんぶ
origamiyoshika	オリガミヨシカ
nagi	凪
toritan	とりたん
nazuchan	なずちゃん
noki	のき
airentaso	あいれんたそ
muru	むる
shun	しゅん
zerohina	ぜろひな
toki	鴇
opatsuko	ぱつこ
riwon	リヲン
numako	ぬまこ
seppuku maru	せっぷくまる
tororo	とろろ
zuxoopa	ずぉおぱ
zakuro	ざくろ
akizu	あきず
tamashe	たましぇ
nebuki n	ねぶきん
pepapipu	ぺぱぴぷ
souta	そうた
ui	うゐ
peso	ぺそ
kabochadonchan	カボチャどんちゃん
honotori	ほのとり
maria	マリア
nyasu	にゃす
maopi	まおぴ
hino miyako	ヒノミヤコ
moyashimo	もやしも
kusunoki mikoto	楠ミコト
coronpi	コロンぴ
koedo magireco	こえどマギレコ
miso	みそ
naofumi	なおふみ
mikango	みかん号
abesawako	安倍佐和子
kiui	きうい
owarishima	終島
sazanami	さざなみ
kakiotu	かきおつ
asahinamitsuki	朝比奈みつき
kakusanbutokyo	カクサン部東京
mikase	みかせ
shimichoco	しみちょこ
kurosuk	くろすけ
makira	まきら
ten	ﾃﾝ
tocochin	とこちん
rin	りん
marufukusatoshi	丸福さとし
moudamepo	もうだめぽ
mao	ﾏｵ
migozuku	みごずく
homuhomu	ほむほむ
gokuakushimura	極悪志村
kusanok	草野
himousya	ヒモウシャ
mo tama	もーたま
isogaba hashire	急がば走れ
tolyoaki	トョアキ
noppi	のっぴ
mugicha	麦ちゃ
kiri	桐
buuuchan	ぶーちゃん
minato	ミナト
kuri	くり
arakidonsan	あらきどんさん
fura	ふら
coronpi	コロンぴ
osusumeshoping	おすすめショッピング
yutone	ゆとね
takaya	タカヤ
aonagi	蒼凪
sakurabasakuran	桜庭サクラ
toyosu	とよす
yokkun	よっくん
hakuji	白磁
dada	だだ
kitunesoba	きつねそば
reiruuu	れいるー
tensha	天赦
namechii	なめちぃー
mikango	みかん号
hyotantsugi	ヒョウタンツギ
huwanekko	ふわねっこ
maepyon	まえぴょん
mesofulan	めそふらん
syouken	しょうけん
aoichan	葵ちゃん
puuta	ぷうた
harekumo	ハレクモ
mizuiharuka	水井はるか
yaasan	やーさん
yakisobakiraida	焼きそば嫌い
osashiminami	おさしみなみ
tatachan	たぁちゃん
natsukusa	夏草
kurageituki	海月いつき
bukininn	武器忍
odangoman	だんごまん
yukawa	湯川
eimi	えいみ
rina	りな
iwachokhi	いわちょき
yume	ユメ
zakkitte	ざきって
hiromaru	ひろまる
torebino azumi	トレビノアズミ
shiratama	しらたま
kakiihiro	柿井ヒロ
rugu	るぐ
satou san	さとうさん
yotsujiakihiro	よつじあきひろ
aru	ある
makegumi	負け組
osiruko	お汁粉
kurogane	くろがね
tokage	とかげ
tsuyutsuki	つゆつき
omiso	おみそ
pikumin	ぴくみん
satorin	さとりん
mozukaso	もずかそ
omikujimegane	おみくじめがね
sorano	そらの
takuanya	沢庵屋
kagami	かがみ
haisenshori	敗戦処理
hiiro	ひいろ
takesin	たけしん
meigenroku	名言録
graburu	グラブル
yamanikun	やまにく
katohman	カトーマン
pakchiriennu	ぱくちりえんぬ
chinsaan	ちんさん
tsubasa	つばさ
imagawa kingyo	いまがわ金魚
tampakun	たんぱくん
paipankan	パイパン館
chikure	ちくれ
kaju	かじゅ
miya	宮
ginnashi	銀梨
horikazu	ホリカズ
katorea	加藤れあ
hirokke	ひろっけ
rioringo	りおりんご
buhikun	ブヒくん
masa udonnokuni	まさうどんの国
mikijou	美姫嬢
sayuta	さゆた
akagi	赤城
sayo	さよ
soshageimo	ソシャゲイモ
mochimochi	もちもち
yuito	ゆいと
daitoi	ダイトイ
toriniku	とりにく
asahi	あさひ
higashinonono	東ののの
hiieragi	柊
meronpan	めろんぱん
macaron	マカロン
ebikatsu	えびかつ
suiseimaou	水星魔王
wo	を
setagaya	せたがや
kikuwa	きくわ
yoshietsuneo	よしえつねお
sai	さい
nanjyakuchan	軟弱ちゃん
satoimo	さといも
omochidama	おもち玉
genkaihounyo	限界放尿
akane	アカネ
hibiyazerosan	ひびやゼロサン
semisigure	蝉時雨
mas omi	まさおみ
yamagasuki	山が好き
yuzutoufu	ゆずとうふ
fuyu	冬
choroken	ちょろけん
wataame	わたあめ
yumi	ゆみ
gan	がん
agochaz	あごちゃ
oshirasama	おしらさま
hamachi	はまち
hirataro	ひらたろう
hayate kirimura	ハヤテキリムラ
goroku	語録
kinako	きなこ
akisuteto	あきすてと
uri	うり
rizume	りずめ
bakiko	ばき子
hibiki	ひびき
hase	はせ
tomo	とも
maho	まほ
gashi miya	がしみや
chikushi	ちくし
naotomo	なおとも
saburin	サブリン
ararin	あらりん
taigyo	たいぎょ
roroi	ろろい
nikachan	ニカちゃん
keita	ケイタ
bakakun	バカくん
yadamon	やだもん
suzukaze	涼風
nagomi	なごみ
meme	めめ
tomomon	ともも
seimei	晴明
kuroneko	黒猫
hamako	はまこ
iyo	いよ
sora	そら
sonkithi	そんきち
bukiko	ぶきこ
kunimotoyuka	國本由佳
funaosu	ふなおす
kakinyako	かきにゃこ
masyumaro	ましゅまろ
kururun	くるるん
kina ko	きなこ
rina	りな
seipakuhasu	セイパクハス
chikafujisan	ちかふじさん
yuusan	ゆうさん
karamerom	からめろむ
nukatuhi	ぬかつひ
kouchin	コーチン
zeninpoanari	全員ポアナリ
zakuro	柘榴
suguru	スグル
rio	りお
enoki	えのき
nekozita	ねこじた
tetomoca	てともか
ayami	あやみ
tachibon	たちぼん
natsume	ナツメ
razu	らず
goma dora	ごまどら
akane	あかね
itemae	いてまえ
hatame	傍目
pyonkichi	ぴょんきち
bakakun	バカくん
akinoshin	あきのしん
ruise	るいせ
azusauta	梓歌
rojiuranocyunen	路地裏の中年
setono osasimi	瀬戸のおさしみ
yamasan	ヤマさん
yuuya	優也
kanitaman	かに玉
zebi	ぜび
tomono	友乃
zebi	ぜび
hiroto	ひろと
midorineko	緑猫
oinemina	おいねみいな
kunieda	くにえだ
hana hana	花はな
kinyami	きにゃみ
momoko	ももこ
jisubon	じすぼん
kuruto	くると
tororo	とろろ
ochamaru	お茶丸
bonta	ぼんた
muraikoutarou	村井幸太郎
kanshirin	かんしりん
misa ki	みさき
shirokuma	シロクマ
karen	カレン
odebusu	おでぶす
mahirume	真昼目
sekibuntoku	積分解く
nerikeshi	ねりけし
rena	レナ
chibesupa	ちべすぱ
kiga	キガ
kimitaka	キミタカ
sai	サイ
okiami	おきあみ
orenokoe	俺の声
waewae	わえわえ
dorekore	どれこれ
moko	モコ
sebonebokiboki	背骨ボキボキ
chipp ii	ちっぴー
fujisame	藤雨
pannnya	ぱんにゃ
takahiro tanak	タカヒロ田中
arare	あられ
kugiranami	鯨波
ababa	あばば
ototetu	音鉄
shonana	ショウナナ
saradapanda	サラダパンダ
rivera yuki	リヴェラゆき
takaiwa	たかいわ
soraran	そららん
yosuga	よすが
omochi okome	おもちおこめ
makomakohonaka	まこまこ本垢
pausan	ぱうさん
nonnon	のんのん
mikango	みかん号
yukinko	ゆきんこ
roki	ロキ
harumaru	はるまる
mitsuba	みつば
karin	かりん
seina	せいな
oruyankee	おるやんけ
shimoyachika	シモヤチカ
yuzukichi	ユズきち
katchan	カッチャン
amano	あまの
shinonome luri	東雲瑠璃
chano	ちゃの
hananagahime	はなながひめ
magumagumaguron	まぐまぐまぐろん
antenna	あんてな
miya	宮
shuwawan	しゅわわん
ko suke	こすけ
sagyougi	作業着
maru	まる
aoineko	蒼猫
hoshi no	ほしの
arupaka	アルパカ
mana	まな
peke puu	ぺけぷぅ
yukinnko	雪ん子
gontakun	ゴンタ君
dichanneo	大ちゃんネオ
pu	ぷ
iori	いおり
mikimaro	みきまろ
nermaki	ねりまき
emodorq	えもどら
kuropo	くろぽ
konyu	こにゅ
monmon	もんもん
mai	まい
hiroki	ひろき
gonbei	ごんべい
andoushuki	安藤周記
ristena	りすてな
yoki	よき
eiji	映児
hizako	ひざこ
tocochin	とこちん
purukuu	プルクゥ
naruko	なるこ
nekota	猫田
aoaki	青秋
akasa	あかさ
netahougaii	ねたほうがい
kusoripu ojisan	クソリプおじさん
konishitama	小西たま
wakonosuke	わこのすけ
shinno rio	しんのりお
kerohirosi	けろひろし
gumyu	ぐみゅ
fusaicchi	フサイっち
roroi	ろろい
kinacomochi	きなこもち
nyokki	にょっき
chiinyanintra	ちいにゃん忍トラ
teken kun	テ研くん
daisike	ダイシケ
ayame	綾芽
sawaki	沢木
mikutoshi	みくとし
keitamihuru	啓タミフル
funanomyi	ふなのみー
syunotora	朱ノ虎
girigiri	ぎりぎり
takeidongebabee	武井ドンゲバビー
papaiyagyunyu	パパイヤ牛乳
souki	ソウキ
fu sagi	フサギ
matsuge	まつけ
sutasisu	スタシス
momoko	ももこ
takosu	タコス
reona	れおな
kuragehunya	くらげふにゃ
hiyokoneko	ひよこ猫
toaruhonzuki	とある本好き
mossama	もっさま
toravisu	トラヴィス
suika	すいか
nyanmomo	にゃんもも
nekomohu douga	ねこモフ動画
yamadananami	山田ナナミ
tekkimon	テッキモン
suginoran	スギのラン
jeankouhai	ジャン後輩
kasabuta	かさぶた
kazuma	かずま
yamanek	やまねこ
tapibarasan	タピバラさん
hanakuma	はなくま
hoto kurage	ほとくらげ
kankitukou	柑橘コウ
mashiron	ましろ
enoki oishi	榎木おいし
pirokaku	ぴろかく
ha akun	はーくん
atalume	あたる芽
terorin	テロリン
nami	なみ
arunoko	あるノコ
marichan	まりちゃん
aruto	あると
yumiyumi	ユミユミ
yukiyuna	ゆきゆな
nomopi	のもぴ
toipopo	トイポポ
fuki	フキ
tsuromuyoshi	ツロムヨシ
sagawa kazuyuki	佐川和之
kokoko	こここ
mayushie	まゆしえ
okaka	おかか
shi san	しーさん
enuya	えぬや
mumu	むむ
madoimeguru	まどいめぐる
maakun	まーくん
tanishigen	谷繁
furitsuna	フリツナ
kikori	木こり
yamaneko	やまねこ
shunshuno	しゅんしゅんお
ibuki	伊吹
pika man	ピカまん
hinoaya	ひのあや
kojio	こじお
wasabijoyu	わさびじょうゆ
negita	祢宜田
kana	かな
rechoko	れちょこ
hamaya	破魔矢
aotongo	蒼斗ンゴ
kinopio	きのぴ
mikamij	みかみ
rinta	りんた
tanmaru	たんまる
izumaru	いずまーる
micha	みちゃ
manarenachiii	まなれなちぃ
nekomodoki	猫もどき
kurotani ariri	黒谷ありり
ahiru	家鴨
nana	なな
reisuke	れーすけ
keita	ケイタ
aabakadana	ああバカだな
sonodarisa	そのだりさ
akao hikaru	赤尾ひかる
kokoro	こころ
sagawa kazuyuki	佐川和之
ikomachannoafri	生駒ちゃんのアフリ
shinga riko	しんがりこ
kanakana	かなかな
ru	る
karouaruaru	過労あるある
gi mugi	ぎ麦
manotake	まのたけ
mokawa	もかわ
akaneko	アカネコ
zura	ヅラ
aikyonano	藍京なの
inemurimajin	居眠り魔神
koitsu	こいつ
otooto	音音
mina to	ミナト
umineko	うみねこ
fukuoka	ふこーか
miyamot	宮本
saba	さば
nasubi	なすび
natumekiyousuke	棗恭介
palutena kopipe	パルテナコピペ
guchiyama	くちやま
mannen surippa	万年スリッパ
kapihami	カピハミ
okakita	岡北
haroran	はろらん
karaitarako	カライタラコ
mamechiiba	まめちば
sa omaru	さおまる
kasumiso	かすみそう
ryuutosabu	りゅーとサブ
nakakoko	中ここ
shinobu	しのぶ
momiji	もみじ
shinamaitake	椎名まいたけ
kinuhei	絹へー
hana	はな
chihiro	ちひろ
shi maro	しーまろ
date morino	伊達もり乃
hachi	はち
bokkionsen	勃起温泉
tetsuo	てつお
kiparis	きぱりす
tanchi	たんち
aaachan	あーちゃん
kohana	こはな
same	さめ
ami	亜魅
hasubot	ハスボー
mokepon	もけぽん
bunharu	ぶんはる
tasogareen	たそがれ円
kotoki	ことき
bokuriho	僕りほ
ekohaku	こはく
yarin	やりん
piyochin	ぴよちゃん
sinonomekitune	東雲狐
uhyou	うひょう
kuroi	クロイ
ayori	あより
pase	ぱせ
takapanda	たかぱんだ
chiimama	ちーまま
kenkuri	けんくり
banira	ばにら
dark mikyankun	ダークみきゃんくん
yasogami	ヤソガミ
nonohara pokota	野々原ぽこた
tokiwa	ときわ
shinshinko	シンシンコ
hi	ひ
muro kishi	ムロキシ
tateko	たてこ
kanamomo	かなもも
konotsuki	このつき
tanaka	たなか
rikyunezu	利休ねず
higu	ひぐ
nannannanon	なんなんなのん
kanochan	かのちゃ
fuwarin	ふわり
kannnoshigeru	菅野茂
hatame	傍目
kouneko	こうねこ
riu	りう
rizume	りずめ
atsuto	あつと
yozora	ヨゾラ
inonogisan	イノノギさん
sora penta	そらぺん汰
chiimama	ちーまま
nana	なな
tetsuo	てつお
duninoru	ヅニノル
rokuji	ろくじ
toravisu	トラヴィス
yoko	よこ
ryochan	りょうちゃん
kokonasuikechan	ココナス池ちゃん
muteki	無敵
soriburu	そりブル
nonotan	ののたん
pipi	ピピ
nishikigoi	錦鯉
rikuru	りくる
kecchon	けっちょん
mochiya	餅屋
puttsun	ぷっつん
manjuu	まんじゅう
ragi	ラギ
kagemaru	影丸
mirea	みれあ
tachi	たち
shapoco	シャポコ
okamo	おかも
kiiroiyane	黄色い屋根
kuu	クウ
parantal	パランタ
noraneko	野良猫
nenten san	捻転さん
misaki	みさき
nevadan	ネヴァダ
moyashii	もやし
fundoshitaro	褌太郎
yui	ゆい
tokuchan	とくちゃん
shomakoto	翔真琴
amiri	あみり
hisasin	ヒサシン
zerokasu	ゼロカス
paisen	ぱいせん
sato naka	さとなか
yuurin	ゆうりん
keiji	ケイジ
umeo	うめお
hatto	はっと
papiko	パピコ
kanou erina	叶絵里奈
mi netari	みねたり
kotora	ことら
sonnnakoto nai	そんなことない
akimiko	あきみこ
meta	メタ
umatan	うまたん
yoasobi	よあそび
mitarasi	みたらし
punkuma	パンくま
pantohachi	パンとはち
ayano	あやの
hiyoshiterari	ひよしてらり
karotta	かろ太
misaki	みさき
kawashi	かわしー
gentuki	ゲンツキ
aisa	あいさ
yuno in	ゆのいん
toeshin	トエシン
ginnosuke	ぎんのすけ
mitsuka	みつか
gentuki	ゲンツキ
parumu	ぱるむ
urahanabi	裏花火
ryosumaruw	りょすまる
monchi	もんち
hittonn	ひっとん
chiiharu	ちいはる
mezoforute	メゾフォルテ
yatara	やたら
habaneruna	はばねるな
senbaduru	千羽鶴
tmichiaki	みちアキ
youkaiondo	ようかいおんど
popoa	ぽぽあ
baru	ばる
susikara	スシカラ
akkarin	あっかりん
chita emon	ちたゑもん
haraki	はらき
sakoto	さこと
yonabari	ヨナバリ
inukai wantan	犬飼ワンタン
yoshimotolumine	吉本るみね
amiigo	あみぃゴ
jaian	ジャイアン
rabyu	らびゅ
aoto	蒼斗
kuina	くいな
ikutayoshikatsu	生田よしかつ
mahusukaya	まふすかや
fuyu	ふゆ
gentuki	ゲンツキ
anko	あんこ
hiro	ひろ
yakoko	ヤココ
yukkurir	ゆっくり
pino	ピノ
shangurira	しゃんぐりら
aoi	あおい
gon	ごん
nanna	なんな
umika	うみか
chia	ちあ
aeka	あえか
matsukichi	まつきち
take	たけ
koha	こは
tobimarujubei	鳶丸十兵衛
egahetako	エガヘタコ
matsuko	まつこ
sasashi	笹史
meganium	めがにうむ
yuru	ゆる
zatsuko	ざつこ
karashicha	からしちゃん
yuuduku	ゆうづく
karen	かれん
dona	ドナ
makkachan	まっかちゃん
mattsun	まっつう
asu faruto	あすふぁると
kai	かい
moka	モカ
chiaki	ちあき
yomogi	よもぎ
myaako	みゃあこ
nayutav	なゆた
watabee	わたべぇ
makicha	まき茶
hitsujisada	ひつじさだ
noaka	ノアカ
nimotch	にもっち
natsuyukii	夏雪
chino	ちの
soba	そば
takuan	たくあん
hanna	ハンナ
hirokamu	ひろかむ
toarukun	とあるくん
hanazono serena	花園セレナ
mao	まお
azun	あずん
sabakama	笹かま
yaya	ヤヤ
shinike	しんいけ
rerameido	レラメイド
i	伊
nosuriko	のすりこ
toramike	とらみけ
kabeko	壁子
rei	零
sora	そら
ponkichi	ぽんきち
natsumikan	なつみかん
oyuzuha	ゆずは
seisyounagon	清少納言
yumeru	夢瑠
hosono	ホソノ
tamagoyaki	卵焼き
souta	創太
taka	タカ
asano natsumi	淺野夏実
simotyamaneko	シモトヤマネコ
mon	もん
konohana	このはな
hanna	ハンナ
eromanga	えろまんが
ruka	るか
oyun	おゆん
sannshi	さんし
manekichi	マネキチ
atsuki	あつき
saki	さき
tamama	たまま
yoshinyan	よしにゃん
imaaano	いまあの
tachibana	たちばな
gaya	がや
hanna	ハンナ
aiko	愛子
akiakane	秋茜
imokenpii	芋けんぴぃ
kusurichanp	くすりちゃん
doi tsunabe	どいつなべ
nakatomiasuka	中富あすか
micchan	みっちゃん
okki	おっき
guraburuyou	グラブル用
ojiro	おじろ
iori	いおり
hashitto	はしっと
izumi	いずみ
takahiro tanak	タカヒロ田中
noriven	のりべん
karotta	かろ太
mako	マコ
nebukuro	ネブクロ
meipuru	めいぷる
kuroro	くろろ
mezoforute	メゾフォルテ
so machin	ソーマチン
kana	かな
rario	らりお
shigesan	しげさん
ta	た
tsukushge	つくしげ
toi	とい
kira	きら
moyashi	もやし
tomomi	ともみ
takapashi	たかぱし
reiko	麗子
kotorinosei	ことりのせい
mezoforute	メゾフォルテ
ikama	いかま
chita emon	ちたゑもん
sakutomo	さくとも
ahiruchan	あひるちゃん
haruhito	はるひと
aju	あじゅ
kishiri	キシリ
kanototori	辛酉
mono	もの
hikaru	ひかる
suzu ri	硯
kotobuki	ことぶき
hiroimu	ヒロイム
chiyarin	ちやりん
manekichi	マネキチ
touzai nannboku	東西南北
chan miki	ちゃんみき
tekuteku	てくてく
mochu	もちゅ
ame	あめ
rasuyan	ラスやん
tajirin	たじりん
onsenboshi	温泉星
tsuruchan	つるちゃん
eiyafiyatora	エイヤフィヤトラ
vorira	ゔぉりら
nodame	のだめ
mizuno	水野
kazumi	かずみ
enrikun	えんりくん
mantaro	万太郎
okino	沖野
nanako	ななこ
yumemako	ゆめまこ
mikokoro koyoi	みこころこよい
atsumin	あつみん
takayuki	たかゆき
hime	ひめ
yukko	ゆっこ
hinomoto	火ノ元
nonchi	のんち
nabo kofu	ナボコフ
shirakawa	白川
smakana	まかな
shizuku	しずく
tsuki	つき
taroshinspa	タロシンスパ
pannakotteri	ぱんなこってり
hokusetsu	ほくせつ
danu	だぬ
suzutuki	すずつき
neotsuchi	ねおつち
noshibeya	のし部屋
koshiryuka	こしりゅか
sakura	桜
zan	ざん
monakasenpai	モナカ先輩
hinako	ひなこ
chokora	ちょこら
pipitori	ぴぴとり
endo jun	遠藤じゅん
nanna	なんな
matubara	まつばら
togariccho	とがりっちょ
cotonami	ことなみ
kazu	カズ
yukiusagi	雪うさぎ
sawayakamikan	さわやかみかん
pochasen	ぽちゃ専
niwakame	にわか雨
namahamu	なまはむ
takuya	たくや
asakoon	あさこん
kuresuko	くれすこ
makaron	まかろん
oyaben	おやべん
ginro	ぎんろ
yuka	ゆか
kyu chan	きゅうちゃん
pii	ぴぃ
oriiyaki	オリー焼き
arishima hina	有島緋ナ
sawagi donchan	騒ぎどんちゃん
manchin	まんちん
towori	とをり
miaki	みあき
chiisanpokopon	ちいさんぽこぽん
sankakupu	さんかくぷー
shiihenakiru	しいへなきる
razu	らず
umi	海
marumori	まるもり
yakuruto	やくると
kazuchan	かずちゃん
anzu	あんず
myomyo	みょみょ
kaimu	カイム
hayate	疾風
anisakis	あにさきす
mumei	無名
kinkan	きんかん
torihiko	鳥彦
harushi	はるしー
seika	せいか
doraneko	ドラねこ
inagakiyasuto	イナガキヤスト
omaccha	お抹茶
hikari	ひかり
ishikoro	石ころ
katutata	カツたた
masahiro	まさひろ
kamakurapasta	鎌倉パスタ
poipoi	ぽいぽい
milukuma	みるくま
hikomaru	ひこまる
rakka	ラッカ
pachiko	ぱちこ
saterait	サテライト
amin	あみん
moppan	もっぱん
rikopin	りこぴん
natumehouseki	夏目宝石
icchannomama	いっちゃんのママ
yotsubakun	よつばくん
kazuchan	かずちゃん
tokumewi	とくめい
kiri	桐
oshiruko	おしるこ
hitsuzi	ひつじ
miyaji	みやじ
aoto	あおと
hosoyang	ほそやんぐ
tsuwamonousagi	つわものうさぎ
gasuya	ガス屋
hayabusa	はやぶさ
riato	リアト
yupe	ゆぺ
hetarehomurasan	へたれほむらさん
kurosana	クロサナ
ezo	えぞ
pipi	ピピ
nekojita	ねこじた
revu	レヴ
hauto	はうと
rendoucha	連動ちゃん
hiyo	ひよ
rariporari	らりぽらり
nobuhiro	信宏
maruhage	まるはげ
kozueko	梢子
yukki	ゆっき
gomashoku	ごま食
mizuki	みずき
yumemi	ユメミ
chia	ちあ
tamu chii	たむちぃ
naoko	なおこ
maboroshinotomo	まぼろしのとも
shia	しあ
satoru	さとる
ebi	えび
akkun	あっくん
moriinaba	もりいなば
hirusugi okita	昼杉起太
yuyasyake	ゆやしゃけ
akabeko kanaha	あかべこかなは
gamisanh	がみさん
huyugumo	ふゆぐも
reo	れお
yamamoyashi	やまもやし
kurouri	くろうり
rui	ルイ
ochan	おちゃん
arima	ありま
norikaku	のりかく
usapi	うさぴ
mesuton	めすとん
hakohama	函浜
rubedo	ルベド
botan	ぼたん
runba	ルンバ
tsugumi	ツグミ
bunorin	ぶのりん
usamemasanobu	卯鮫正信
yurika	ゆりか
nannchan	なんちゃん
ichigochoko	苺ちょこ
makegumi	負け組
miyu	みゆ
pyon	ぴょん
saka	さか
himi	ひみ
momorinmeri	ももりんめりー
naa	なあ
nemuchi	ねむち
chaso	ちゃそ
yuribow	ゆりぼう
ginnosuke	ぎんのすけ
mugi	麦
kanso kurumi	乾燥クルミ
anemo	あねも
chiesha neko	知恵捨猫
chiibuu	ちいぶー
hinase	ヒナセ
unya ko	うにゃこ
raki	らき
mugicha	麦茶
numa	ぬま
sibidori	しびどり
maru	まる
shiki harukaze	四季春風
temuyu	てむゆ
ohanachan	おはなちゃん
choshinsei	超新星
onigirisenbeiyo	おにぎりせんべい
nippori	日暮里
omeme	おめめ
shimatofu	シマトフ
taison	タイソン
kawarashima	河原嶋
rokuyongo	ロクヨンゴ
hinatan	ひなた
mori	もり
kuzutetu	くず鉄
otoha	オトハ
maromaro	まろまろ
rinka	りんか
makomokoo	まこもこ
goetaro	ごえたろ
noraosamu	野良修
okuchan	おくちゃん
bobinzuru	ぼびんずる
mui mui	むいむい
tamurasaketen	田村酒店
miiko	みーこ
tokizami	ときざみ
kamikochikappa	上高地河童
maman	ママン
osatsu	おさつ
iku	郁
io miya	いおみや
seina	せいな
amatsuhitsuki	あまつひつき
hinaano	ひなの
shiroju	しろじゅ
miuka	みうか
marukamato	まるかまと
subaru	昴
kazupon	かずぽん
hasuhisax	はすひさ
talutoru	タルトル
otosuke	オトスケ
sibababababa	しばばばばば
saku	炸
matako	またこ
so	そ
youkouro	溶鉱炉
kaname	ｶﾅﾒ
penta	ぺんた
tarou	太郎
hino gupo	日野ぐぽ
kaitoma	かいとま
riruna	りるな
yuyumeme	ゆゆめめ
toranekobiyori	とらねこ日和
hitotose	ひととせ
yurion	ユリオン
yoneda koromochi	米田ころもち
gantetsu	がんてつ
yodomori	よどもり
ouji	王子
ryuubukuro	龍袋
satoteshisuto	ｻﾄﾃｼｽﾄ
tomosan	ともさん
takuo	たくお
suuchan	すぅーちゃん
vaara	ヴァーラ
kaitoma	かいとま
haikaraichiban	ハイカラ一番
uryaa	うりゃあ
tomosan	ともさん
tana maru	たなまる
kazemakase	風まかせ
yukke	ユッケ
higasa	ひがさ
torokon	とろこ
mame po	まめぽ
hina	ひな
nattougopan	納豆ごぱん
talutoru	タルトル
sabakama	笹かま
donkachi	ドンカチ
yawaragi	やわらぎ
rin	りん
moguninnin	もぐにんにん
aowain	青ワイン
nano	なの
mimitan	みみたん
fu tsuki	ふぅつき
yukitai	ゆきたい
pako	パコ
okunawa	おくなわ
kamiko pu	紙こっぷ
omaruchan	おまるちゃん
rei	れい
suraa	スラア
ogawan	おがわん
harukaze mebae	春風メバエ
inemuru	いねむり
nomikke	のみっけ
riko	りこ
torisuki	鳥好き
michi	みち
azuazuki	あずあずき
ryonyakunyannyo	ろうにゃくにゃんにょ
touyama	とうやま
mafiru mario	まふぃるマリオ
woruma	をるま
minezaki	峯崎
renya	れにゃ
kana	かな
kokui	こくい
mikarinoshi	みかりノシ
chiyu	ちゆ
dego	デゴ
mon	もん
neruru	ねるる
ginko	ギンコ
neconyansensei	猫にゃん先生
akoratta	アコラッタ
oidakichan	追い焚きちゃん
mirai	みらい
nagoyori	なごより
kombujio	こんぶじお
ahiruchan	あひるちゃん
watabou	わたぼう
kudopero	くどぺろ
niseojiro	ニセオジロ
sumi	すみ
koucchi	こうっち
mashimarusoft	ましまるソフト
mirinsouu	ミリンソウ
gorugo	ゴルゴ
zakkyozaru	雑居猿
maikun	マイ君
hinoki	ひのき
semi	せみ
garesu	ガレス
nora ichigo	野良苺
mikku	みっく
kamakurapasta	鎌倉パスタ
sawatei	さわてぃ
onose	おのせ
yumemikyabetsu	夢見キャベツ
pankirin	パンキリン
kombujio	こんぶじお
chan mio	ちゃんみお
kuu	くぅ
sayuki	紗雪
asunaro	アスナロ
yasushi	やすし
masayan	まさやん
yamiri	やみり
yujimiya	ユジミヤ
kozue	こずえ
majin kun	魔神くん
arisa	ありさ
setudentarou	節電太郎
yotto	よっと
nyakayubi	中指
toshiaki	としぁき
okazu chan	おかずちゃん
asagiri	朝霧
takenokoyaroo	たけのこ野郎
potapenko	ぽたぺんこ
aibotomirusekai	相棒と見る世界
dora	どら
kisoriron	基礎理論
watarininja	ワタリニンジャ
zunmochikoa	ずんもちこあ
buchi	ブチ
aji iwashi	あじいわし
suika	すいか
tomozu	ともず
tumepon	つめぽん
hare	はれ
sakuragi	桜木
saito marukome	齋藤丸ごめ
fumipon	ふみぽん
matsuryun	松竜
shirasu	しらす
zukapota	ヅカポタ
ramuchan	ラムちゃん
soara	そあら
asajiri	アサジリ
marumiyakun	まるみやくん
haruse	春瀬
riona	りおな
sangon	さんごん
ryutaronronman	りゅうたろんろんマン
kisaragirin	如月凛
setudentarou	節電太郎
kusugaya	くすがや
sakatamakii	坂田まき
kuu	クウ
yuu	ゆう
nonsoyo	のんそよ
harami	ハラミ
yunyu	ゆんゆ
chinatsu	ちなつ
karaage kun	からあげクン
yazora	やぞら
sakutaro	さくたろう
yatara	やたら
haroharo	はろはろ
tsukika	つきか
neko datemaki	猫だてまき
roka	ろか
misaki	みさき
kakkaku	赫赫
kure kirika	呉キリカ
umeko	梅子
suzunariya	鈴鳴り屋
shinorua	しのるあ
omatomesann	おまとめさん
dayo dayo dayo	だよだよだよ
sumikawa	墨川
shiro tsumekusa	しろつめ草
edasasami	えだささみ
nyanzaki	にゃん崎
ekotora	エコトラ
bansai	バンサイ
purehab	プレハブ
utame	うため
roni	ロニ
hashiguchi	橋口
rarikkusu	ラリックス
aochin	あおちん
gon	ごん
warabi mochi	わらびもち
kameokago	亀岡語
aisu	アイス
yumiko	ゆみこ
marikichi	まりきち
nobou	のぼう
hirotaka	ひろたか
karasudo	烏堂
kirisaki ayano	霧咲アヤノー
rozurozu	ろずろず
chuu jou	ちゅうじょう
shiochang	しおちゃん
yamadaya	山田屋
takamura	たかむら
hanamama	おはなママ
katsuragi	桂木
miarekaina	ミアレカイナ
nabsuko	ナビスコ
kotuurou	こつうろう
mikaking	みかきんぐ
arimakinen	有馬記念
ibuki	伊吹
hotategai	ホタテ貝
cyodogorou	ちょど五郎
haka	はか
nonkebitch	ノンケビッチ
younagi	ゆうなぎ
zean	ゼアン
yamadaya	山田屋
tsuba	つば
kogorinn	こごりん
riruremon	りるれもん
ichi	いち
mi chuu	みちゅう
zako	ざこ
rozurozu	ろずろず
kamepengin	カメペンギン
hakaisasya miru	はかいさしゃみる
omomames	おもまめ
irina	いりな
sakana	サカナ
indeg o	インデゴ
hiiro	緋色
yutamaru	ゆたまる
hikari	ヒカリ
ayuna	あゆな
yamosabo	やもさぼ
sosorori	ソソロリ
furikake	ふりかけ
tukichiko	つきちこ
nekomerotan	ねこめろたん
koke	こけ
nekotuna	猫綱
saten	サテン
akito	あきと
gitao	ぎたお
nao	ナオ
vianka	ヴィアンカ
yuji	ゆじ
tabayoshiki	たばよしき
mikaduki	みかづき
rikoru	リコル
orisei	オリセイ
necoonsen	ネコ温泉
karuron	かるろん
takemaru	たけまる
sankiyo	さんきよ
ichan	いちゃん
mion	みぉん
hosoyang	ほそやんぐ
runa purin	るなプリン
kurohebi	黒蛇
yumeban	ゆめばん
poi tara	ぽいたら
nonbiri	のんびり
minamikoora	南コーラ
senri	せんり
miyakotto	みやこっと
naoruhi	なおるひ
honnenopapa	本音のパパ
arumaji	アルマージ
ichino	いちの
mizuki	みずき
mottoyamamoto	モットヤマモト
meguri	めぐり
irori	囲炉裏
watasyou	わたしょう
sankakuteaa	さんかくてあ
kuma no	くまの
uniguri	うにぐり
kamonokamekame	かもーのかめかめ
nainai	ないない
cheru	ちぇる
yuzuriko	ゆずりこ
hiiro	ひいろ
kame kichi	かめ吉
sakurapanda	さくらぱんだ
iyuka	いゆか
beru	べる
koyata	こやた
panpukin	ぱんぷきん
zurizurin	ずりずりん
sirotan meigen	しろたん名言
hiro chin	ヒロちん
gyouninben	ぎょうにんべん
macha	まちゃ
tsushima	津島
himekapo	ひめかぽ
okaraneco	おからねこ
bora	ぼら
oto	おと
aran araki	アラン荒木
azamin	アザミン
michirum	みちる
uyamuya	うやむや
taikutu	たいくつ
ichi	いち
pechi tarou	ペチ太郎
irukujira	イルクジラ
marucoshi manta	まるこしまんた
manohochi	間野ホチ
chi	ち
zumo	ズモ
miyamalon	みやまろん
mamoyarotao	まもやろたお
ameda	あめだ
shirasu pu	しらすーぷ
beshimajinari	べしまじなり
karuto	カルト
uranami	うらなみ
nekojita	ネコジタ
yokatako	よかタコ
hayonero	はよねろ
hiyori	日和
anemone	アネモネ
isemagu	いせマグ
shirokuma	しろくま
radauta	ラダウタ
kogameru	こがめる
chizuru	千鶴
nako	なこ
gorogoro	ごろごろ
mou tana	盲タナ
xenoranto	ゼノラント
taketon	たけとん
kokoro	こころ
bondhinu	ボンディーヌ
kenkuri	けんくり
neotaru	ねおたる
mirumequ	みるめぐ
omami	おまみ
okan oshitari	おかんおしたり
shimapo	しまぽん
mogunoshin	モグノシン
enuenu	えぬえぬ
umiuri	ウミウリ
kuropo	くろぽ
gyouzachan	餃子ちゃん
rianya	りあにゃ
nekoarashi	ねこあらし
daikun	だいくん
kani juu	蟹充
muuru	むーる
usapu	うさぷ
kanakichi	かな吉
uhiku	うひく
mamoyarotao	まもやろたお
hinatan	ひなた
kako	かこ
minto	みんと
mitsuwe	みつえ
papipu	ぱぴぷ
kamaboko	かまぼこ
ueeee	うええええ
ringoame	りんご飴
arumaji	アルマージ
nan roumaru	なん郎丸
toubun ou	糖分王
miru miru	みるみる
furanorana	ふらのらな
mikan	みかん
kyon	きょん
samazin	サマジン
koguwa	こぐわ
mirai	みらい
yuukichi	ゆうきち
misogyuunyu	味噌牛乳
aihara	相原
mikkun	みっくん
kanon	かのん
midori	みどり
kopakoa	コパコア
genji	げんじ
hinikino	ひのきの
mumu	むむ
saki	咲
motoko	もとこ
suzukiyasuyuki	鈴木泰之
tomowaka	ともわか
kiui	キウイ
tajima	田島
mittsu	みっつ
mafura niki	マフラーニキ
kamewai	かめワイ
araikio	アライキオ
sakuraa	さくら
ika	いか
togi	トギ
tarezou	たれぞー
techitaro	てちたろ
pukkun	ぷっくん
warabimo	わらびも
toyama tama	戸山タマ
basakiat	バサキア
edonko	えどんこ
onichanneru	鬼チャンネル
tamreon	たむれおん
suu repo	すうれぽ
hagi	はぎ
roi	ロイ
narupajin	ナルパジン
shika	しか
ippo	いっぽ
inaina	いないな
yu tamagosan	ゆうたまごさん
poppotan	ポッポタン
kiriu nagi	きりうなぎ
sakasama	さかさま
kotorin ko	コトリん子
kasasama	カサさま
chiko	ちこ
tomi	とみ
shimishimi	しみしみ
yuragi	ゆらぎ
mirai	みらい
hitorigoto	ひとりごと
suzuhi	スズヒ
kinsan	きんサン
mentai furikake	明太子ふりかけ
innaka	いんなか
zeno	ゼノ
kana	かな
kurorain	くろれいん
toki	とき
ayato	綾斗
onasu	おなす
tokei	時計
tsurara	つらら
soyo	そよ
ahiruchan	あひるちゃん
nanaonao	ななおなお
yuusaku	ゆうさく
kya	きゃ
komasan	コマさん
takepon	たけぽん
inagakiyasuto	イナガキヤスト
kichida	きちだ
ri	り
npi	んぴ
saritote	さりとて
soramame	そらまめ
miru toto	ミルトト
rezamari	レザマリ
tamasiro	たましろ
hinoduka	ひのづか
nan suki majide	ナンすきマジで
nabehuki	鍋拭き
fukuha	ふくは
sawayanagi	サワヤナギ
rinuraaka	りん裏垢
shikounofuukei	至高の風景
iwahashi mika	岩橋美佳
utozukki	うとづき
satomin	さとみん
gami	がみ
kirua	きるあ
petan	ぺたん
yuyu ta	ゆゆた
neritake	ねりタケ
satokun	さとくん
koge	こげ
taka	たか
meronpan	メロンパン
sai	采
roro	ろろ
yukichoko	雪チョコ
momotosen	桃戸千
moka	もか
arusuta	あるすた
akikan	あきかん
hachioji kurumi	八王子胡桃
aki	あき
shinata	しなた
takoyakikozo	たこ焼き小僧
roeru	ロエル
sayurin	さゆりん
tekunomo	てくのも
nagare	ながれ
miku	みく
saro	さろ
sanocchi	さのっち
unikurage	うにくらげ
nonno	のんの
pokumonu	ポクモヌ
muchiko	むちこ
yoshitomo	よしとも
torami	とらみ
katuhiko	かつひこ
chibimu	ちびむー
danzou	ダンゾウ
hariusagy	針兎
chiaki	ちあき
taihei	たいへい
korosuke	ころすけ
aka ten	あかテン
mimarea	ﾐﾏﾚｱ
kuromitsu	黒蜜
tonton	とんとん
nekokan hima	ねこ缶暇
kiriu	きりう
nari	なり
oume	おうめ
yuriia	ゆりいあ
ringo zake	りんござけ
anko	あんこ
hanamaru	はなまる
magochin	まごちん
yuka	ゆか
otamaru	おたまる
neron	ねろん
kiyosuke	きよすけ
matsuda	松田
heibonta	へーぼんた
yuusuke	ゆーすけ
mo soso	もそそ
udonko	うどんこ
nanahoshi	ななほし
hagecyabin	はげちゃびん
haruchan	はるちゃん
tesshi	てっし
herenun pon	へれぬんぽん
dozaimonta	どざいもんた
hoshinabe	ほしなべ
makotemu	まこてむ
mei	メイ
okapi	おかぴ
kuuta	くぅ太
wanta	碗太
dorama netabare	ドラマネタバレ
haseramuda	ハセラムダ
ekure	エクレ
metappou	メタッポウ
matsu	マツ
nanna	なんな
midori	みどり
toshi	とし
kinokuchi	キノクチ
yuunyan	ゆうにゃん
minomusi	ミノムシ
ohuromuramasa	おふろ村正
azuma	アズマ
meto	めと
koumei	こうめい
kinakomochi	きなこ餅
taka shi	たか氏
mimei	ミメイ
hota chiyo	ほたちよ
akihikuy	アキヒク
hokumaru	ほくまる
yama chan	山ちゃん
gen	げん
mikyan	みきゃん
yodasemaru	よだせまる
tanin	他人
mizuiro	みずいろ
muchiko	むちこ
iroha	いろは
miru	ミル
tabuneko	たぶねこ
madarame	まだらめ
shima yuru	志摩ゆる
hanashiawanai	はなしあわない
keanabijin	毛穴美人
kuiijisokuhou	食い意地速報
nemui	眠い
showyan	しょうやん
shino	シノ
yasutomo	ヤストモ
arimainochi	有馬命
chieno umi	智慧の海
mano ikumi	間野いくみ
macaron	マカロン
tomatoma	とまとま
neon	ねおん
yakepachi	ヤケパチ
zerotsuki	ぜろつき
yamauni	やまうに
senya	せにゃ
tsukumo	つくも
amaguri	あまぐり
asano gi	あさのぎ
riku	陸
semihito	せみひと
minamo	ﾐﾅﾓ
kaisyawoyameyo	会社を辞めよう
nontaro	ノン太郎
amano onsa	天野恩紗
matcha	まっちゃ
dorama netabare	ドラマネタバレ
hinagiku	ひなぎく
momo	もも
sasakama	ささかま
popon	ぽぽん
manekineko	まねきねこ
tsumugi	つむぎ
kuchikominist	口コミニスト
meacha	めあちゃ
aya	あや
higepa ma	髭パーマ
piyohiko	ぴよしこ
ichi kokumin	一国民
asu	あす
mokoimo	もこいも
usat amu	うさたむ
somu cha	そむちゃ
mojame	もじゃめ
nakae	中江
debumaki yaizu	でぶマキやいづ
mogami	もがみ
kino	キノ
aoi anzai	あおい安斎
sugiyan	すぎやん
ruri	瑠璃
shirako	しらこ
tacchan	たっちゃん
ushinobanicu	牛の馬肉
bisuketan	ビスケたん
muninichi	むににち
maiko	まいこ
asuka	飛鳥
shirogoto	しろごと
oishiiiiniku	おいしいいいにく
koishiro	恋しろ
yuse	湯瀬
daihuku	だいふく
ochomo	おちょも
hatori	はとり
yukina	ゆきな
kuro udo	くろぅど
kodamacchi	こだまっち
kenkuri	けんくり
rumika	るみか
dokupe	ドクぺ
sake	さけ
shiatoro	しあとろ
yusa	ゆさ
kinyami	きにゃみ
usagi	うさぎ
mashumaroinu	マシュマロ犬
mainu	まいぬ
chaso	ちゃそ
tani	たに
nakanatsu	なかなつ
yokoshima	よこしま
matsuge	まつげ
komai	こまい
shunsuke	シュンスケ
araiguma	あらいぐま
suzu	すず
sasurai	さすらい
asano	浅野
saezuki	さえづき
fukurosan	フクロウさん
horigotatsu	ほりごたつ
kokudougou	国道号
bebisura	ベビスラ
okamekorokoro	オカメコロコロ
akai yasero	赤井痩せろ
minase	みなせ
kounotori band	こうのとりバンド
rikka	立夏
roro	ろろ
amane	あまね
kusomushimika	くそむしみか
airu	愛瑠
hakonet	ハコネ
nikumaru	ニク丸
kumamotoaichi	熊本愛知
shika	鹿
hapihapitch	はぴはぴっち
kussuu	クッスー
moritani	もりたに
ienire	家楡
hoku	ほく
akaikani	あかい蟹
shima	しま
moromi	醪
nekonoizumi	猫の泉
kinkan	きんかん
satoken	さとーけん
oniku	お肉
natsumew	なつめ
akemon	あけもん
bunpuku	ぶんぷく
hitorigotonansu	ひとりごとなんです
katsukara	かつから
tachi	たち
ninose	二ノ瀬
momoan	ももアン
yuuka	ゆうか
reina	れいな
kuchikominist	口コミニスト
futodoki	ふとどき
tanisinokyojin	タニシの巨人
shun	しゅん
yokota	よこた
kanata	かなた
jisyaku	磁石
chacha	ちゃちゃ
karasuma	烏マ
atatata	たたたた
rurutaro	るるたろ
tanapyon	たなぽん
yaku	やく
kurutoga	くるとが
harukana	はるかな
jatako	じゃた子
inukun	いぬくん
ayamaru honaka	あやまるほんあか
boroboton	ボロボトン
naro	なろ
yaabon	やぁぼん
takorun	タコる
seto	せと
oguragawa	おぐらがわ
osashimi	さしみ
bassa	ばっさ
hoichi	ほいち
yamashin	やましん
koimo	こいも
tomomo	ともも
pengin	ぺんぎん
azu porin	あずぽりん
kaname	ｶﾅﾒ
mikan	みかん
namako	なまこ
mashiro	ましろ
akitakeda	あきたけだ
buu	ブウ
kounyan	こうにゃん
hidebu	ひでぶ
saeki	佐伯
otomeko	おとめ子
hinata	ひなた
hayane	早寝
rintaku	りんたく
buripan	ブリパン
imachan	ぃまちゃ
reira	レイラ
hogarakapapi	ほがらかパピー
doze	どぜ
aoi	あおい
zerokasu	ゼロカス
wayu	ゎゅ
garigarikun	ガリガリ君
matsumoto	まつもと
hagirooo	はぎろー
kui	杭
ryouki	涼季
arue	あるえ
yami koi	病み恋
aoi same	青井さめ
kokekow	こけこぅ
kikuchi	きくっち
zarabu	ざらぶ
toushi meigen	投資の名言
damedame shufu	だめだめ主婦
izumi	いずみ
noi	のい
shima risu	しまりす
toppinparary	とっぴんぱらり
suraimu	スライム
miffeei	みっふぇー
yakuoyoso	約およそ
mirin	みりん
keyaki tora	欅虎
mi	み
takuteitoku	たく提督
tetsuki	テツキ
chibibi	ちびび
warumo	わるも
meguun	めぐーん
aiai	あいあい
mosidora kopipe	もしドラコピペ
mimionigiri	みみおにぎり
nari	なり
nakamura	中村
ei hire	エイヒレ
hehohounsoh	ヘホホ運送
nayuta	なゆた
tapitanyan	たぴたにゃん
kurono	クロノ
ithinen	イチねん
pakutto paseri	パクッとパセリ
mikeke	みけけ
kiichi	きーち
shachi	シャチ
narumi	なるみ
natsu	ナツ
uri	瓜
komakimako	こまきまこ
memmoku	めんもく
tsukasa	つかさ
peru jona	ペルジョナ
ababa	あばば
ronronron	ろんろんろん
wanzouko	わんぞうこ
mitsukajimaya	ミツカジマヤ
mia	みあ
kerutarosu	ケルたろす
rena	れな
takayan	たかやん
wata	わた
mucchan	むっちゃん
urisan	うりさん
tsunsun	つんつん
kuro	くろ
noripan	のりパン
koba	こば
no	の
miyutama	みゆたま
ikech an	池ちゃん
kanaedesu	佳苗です
tamreon	たむれおん
megmyon	めぐみょん
shinomiya	篠ミヤ
akiho keiba	あきほ競馬
okutan	おくたん
kurwanko	くろわんこ
suzumebachi	すずめばち
masutch	マスッチ
otohachi	音はち
kuni haru	くにはる
honmushi	本虫
chamchi	ちゃむち
asai hinata	アサイヒナタ
shino	しの
kana	かな
aoto	あおと
ooiminami	大井みなみ
kyutte	きゅって
konta	こんた
nanoha	なのは
yopiko	よぴこ
hirokazu	ひろかず
nagae sato	ながえさと
chiroru	チロル
dentetsu	でんてつ
enyou	エンヨウ
shakku	しゃっく
chibi	ちび
tetsugaku	哲学
kiraso	キラソ
mio	ミオ
narutora	なるとら
takashi	たかし
reira	レイラ
taiju	たいじゅ
ningen neko	人間ねこ
nonon	ののん
kouon	こうおん
nekomakura	猫枕
tamago	たまご
torehantosihiko	トレハン俊彦
kamakurapasta	鎌倉パスタ
nubuchan	ぬぶちゃん
rarato	ららと
toriri	とりり
kenjadora	賢者ドラ
miyu	みゆ
funaosu	ふなおす
kojikojiro	孤児コジロー
jin	陣
kamuro	かむろ
koppen	こっぺん
motocondoria	モトコンドリア
chi bita	ちびた
kuma	くま
chachamaru	茶々丸
mitsukajimaya	ミツカジマヤ
sunsun	すんすん
tamu	たむ
uruhaa	うるはぁ
shinohara	しのはら
futtora	ふっとら
matsuge	まつげ
yuno	ユノ
nako	なこ
mikeneko	三毛猫
subarun	すばる
ninuki	にぬき
nadema shouka	なでましょうか
kureguma kurage	暮熊海月
airi	あいり
yukikaze	ゆきかぜ
makonam	まこなみ
jaga	じゃが
tateo	たてお
sagara azumi	相良あづみ
e	ゑ
mihosakura	みほ桜
yuuu	ゆうう
esunai	えすなゐ
shokora	ショコラ
kino	紀乃
shichimi sazan	しちみさざん
asagi	あさぎ
kanaya	かなや
yume	夢
narumin	なるみん
shapoco	シャポコ
yuu nyan	ゆうにゃん
nemuinezumi	ねむいねずみ
heiya musu	塀屋無洲
hoshiume	干し梅
okinamiura	オキナミウラ
osamuchin	おさむちん
o tsuyu	オツユ
chicori	ちこり
meronpan	メロンパン
kimusyun	きむしゅん
chabu mama	ちゃぶママ
kitano tobi	北の鳶
chiroru	チロル
amamizu	雨水
sumidagawa	隅田川
yurinenko	ゆりねんこ
shirotume	しろつめ
keisuke	けーすけ
arurira	あるりら
benisiro	べにしろ
akaitokei	紅い時計
vanpi ru	ヴァンピール
nini	にに
kamiwokun	かみをくん
sana ragumasu	沙菜ラグマス
bukiyoutouchan	不器用父ちゃん
yuri	ゆり
bariguachi	ばりぐあち
ahiruchan	あひるちゃん
omochi	おもち
kobayansu	こばやんす
kazune	かずね
yukiyukiyu	ゆきゆきゆー
kokatorisu	コカトリス
kirara	きらら
yuukei	悠景
osakana	さかな
yasu	ヤス
nyanko	にゃんこ
historiamirano	ヒストリアミラーノ
inagakiyasuto	イナガキヤスト
makira	まきら
takamiku	たかみく
nini	にに
hamutan	ハムたん
tanmei chan	短命ちゃん
tsukino miyako	月野みやこ
honkawa	ほんかわ
thujimiki	辻みき
mori rin	もりりん
ruto	ると
gominoesa	ゴミの餌
kamimo ri	かみもり
rururu	るるる
satorenko	サトレンコ
ren	憐
mamedakou	豆田コウ
yukishiki	ゆきしき
rasetsu isuka	ラセツイスカ
papi rusu	ぱぴるす
kosyamaru	こしゃまる
atobejunjun	跡部じゅんじゅん
asari	あさり
marumedia	まるめでぃあ
odangoman	だんごまん
hataraki ari	ハタラキ有
kuroki	くろき
koko ro	こころ
kaname	かなめ
kotori	コトリ
taruten	タルテン
odoro	オドロ
pasuta	パスタ
nagase	ながせ
wata yuki	ワタユキ
kumacchi	くまっち
non	のん
ponjiro	ぽんじろう
kohsakajun	香坂純
yakimonos an	やきものさん
wakamatu	ワカマツ
buruha	ブルハ
ramochi	らもち
endo jun	遠藤じゅん
hagakikatteren	ハガキ勝手連
horidon	ほりどん
opatsuko	ぱつこ
tesona	テソナ
ringo	林檎
kamo	かも
nemuinezumi	ねむいねずみ
asatsuki	あさつき
toma	とま
temarineko	手毬猫
hima	ひま
ono onose	おのオノセ
endo jun	遠藤じゅん
mizuha	みずは
tenkinomiko	天気の巫女
yuki	雪
sayonaka	さよなか
gurakongu	グラコング
hukkinhaikin	ふっきんはいきん
guraburu	ぐらぶる
kazkaotami	かずかお民
haruna	はるな
yuzu desu	ゆずです
hikosan	ヒコさん
mitsuru	みつる
tomozu	ともず
anzu	あんず
shibainukichi	しばいぬきち
han	はん
matatabu	またたぶ
kamome	かもめ
mona	もな
noshimochi	のしもち
taru ringo	たるりんご
yuuyami	ゆうやみ
kumami	くまみ
hamada	浜田
asatsuki	あさつき
eite	エイテ
reinadon	れいなどん
jako	じゃこ
mochi	もち
matsuge	まつげ
hikosan	ヒコさん
harukak	はるか
kachimushi	勝ち虫
yamanotakasi	やまのたかし
nagomu	なごむ
kawakoh	カワコウ
sentakuneco	せんたくねこ
nanoka	なのか
migozuku	みごずく
uraaka	裏垢
yuzutaro	ゆず太郎
kanako	加奈子
hekiryu	碧琉
reigi	玲儀
taniyama noko	谷山のこ
yougano	よーがの
unago	うなご
desune	ですね
nanamushi	ななむし
yuka	ゆか
motoso	もとそ
umi ushi	うみうし
tsuyoshi	つよし
tomotaros	ともたろす
raichi	らいち
toriri	とりり
migozuku	みごずく
migozuku	みごずく
nono	ノノ
ikatake	いかたけ
akatuki	暁
kurokka	クロッカ
wakame cha han	わかめ炒飯
anehime	あねひめ
yozakra	夜桜
ai	あい
nakochi san	なこちさん
mikami takeru	三神たける
yamaman	やままん
serusio	せるしお
seisai	正妻
moyasineko	もやしねこ
uzura	うずら
owaten	オワテン
netukotan	ねつこたん
nagisa	渚
toriinu	とりいぬ
totohchan	トトオちゃん
enumu	えぬむ
acha	あチャ
akita	あきた
chihaze	ちはぜ
yurariro	ゆらりろ
kotoko	古都子
kimikun	キミくん
haivu	ハイヴ
kosodate baken	こそだてばけん
jouko	嬢子
machio	まちお
shouta	翔汰
funkorogashi	ふんころがし
reni	れに
tama	たま
mizumo ri	水杜
watage hiyoko	わたげひよこ
sorano	そらの
ryutaronronman	りゅうたろんろんマン
saotaya	さおたや
akitukikoko	あきつきここ
ochisa	おちさ
ishidacchi	いしだっち
miyafuji	みやふじ
saburin	サブリン
yuzu pon	ゆずぽん
kazethukai	風使い
kira	きら
aonori	青ノリ
hinatabokkopoka	ひなたぼっこぼこ
kamakurapasta	鎌倉パスタ
hima	ひま
yon ten	よんてん
sayaka	さやか
tarotaro	たろたろ
nuime	ぬいめ
hachikiku	ハチキク
kimagureryu	気まぐれりゅう
nana	なな
takubon	たくぼん
kaku	かく
yoitomake	ヨイトマケ
baobabu	バオバブ
marimon	毬藻ン
dokayama	ドカ山
suzukuma	鈴熊
saki	さき
byaon	びゃおん
kako	かこ
kuroki karen	黒跪カレン
suratan	すらたん
shion	シオン
tokumewi	とくめい
yu anao	ゆあなお
kanata	かなた
ron	ロン
mamimaminomami	まみまみのまみ
inugami	いぬがみ
hagayui	はがゆい
manpukujidou	満腹児童
harukio	はるき
rorun torihiki	ろるん取引
wasabimaru	わさびまる
kotobuki	ことぶき
emanieltakashi	えまにえるたかし
keisuke	けーすけ
hime	姫
reikun	玲君
michiroid	ミチロイド
irosyumiikasama	イロシュミイカサマ
toshi	トシ
kuroinu	黒犬
oden	おでん
soraha	そらは
hepichan	へぴちゃん
hisui aya	翡翠あや
keisuke	けーすけ
kiyo kiyo	きよきよ
serenankotu	セレ軟骨
arikino	アリキノ
hiro	ひろ
tomichikaw	トミチカウ
takana	たかな
tsuruko	ツルコ
ikaruga	いかるが
rin hime	りんひめ
gachirin	がちりん
syojikku	ショジック
iisyokuba	いい職場
yuuyu	ゆうゆ
gaku	がく
honemi	ほねみ
origami otaku	折り紙オタク
kokatorisu	コカトリス
atamaru	あたまる
riri	りり
noeru	のえる
retsuya reka	烈弥れか
kaori	かおり
samonja	さーもんじゃ
zukinbousi	ズキン帽子
matsugo	松号
rin neko	りん猫
denjikigaku	電磁気学
osakana	さかな
othukimi	おつきみ
suzumebachi	スズメバチ
jyuniku	受肉
maguri	まぐり
yayuta	やゆた
yassunn	やっすん
houji cha	ほうじ茶
ta	た
sawahato	サワハト
nomuchi	のむち
sayuyun	さゆゆん
rikakochama	りかこちゃま
zuya	ずや
ponyamada	ポン山田
akatukisora	暁空
mayu	まゆ
damutoro	ダムトロ
hana	花
yukiyuna	ゆきゆな
zenigame	ゼニガメ
akinosora	秋野ソラ
utaufumendai	歌う譜面台
toyoshin	とょしん
tarutaru	たるたる
powatto	ポワット
tsutsuji	つつじ
tamamo	たまも
ameyuru	あめゆる
kanya	かにゃ
naeka	なえか
kureyon	クレヨン
kawase	カワセ
fugashi	ふがし
hoshi kuzu	ほしくず
shikibu meguri	式部めぐり
rakkyoumiso	らっきょう味噌
fujiwara	藤原
sunooden	須野おでん
shiro kuma	しろくま
himawaritaanee	ひまわりのたーねー
nufufu	ぬふふ
mameshiba	まめ柴
maniwakoumori	真庭蝙蝠
daichan	だいちゃん
howachan	ホワﾁｬﾝ
purakaru	ぷらかる
kuraisfia	クライスフィア
marobokujo	マロ牧場
togemachi	とげまち
oka	おか
hinachai	ひなち
nekokuma	ねこくま
marusan	丸さん
rui	るい
marimokkori	まりもっこり
ninjin	にんじん
yayuta	やゆた
shiozaia	シオザイア
hebihenge	へびへんげ
shigure	しぐれ
imuncho	いむんちょ
minegishinegi	みねぎしねぎ
bangren	バンレン
kimuchi	きむち
maru	まる
mandarino	まんだりん
hhomahi	ほまひ
manchin	まんちん
momo tarou	桃太郎
nanifamu	なにふぁむ
sasagann	ささがん
pacho ishi	パチョ石
makihara	まきはら
azu	あず
koaramaru	コアラ丸
urumetchi	ウルメッチ
marinar	まりな
penyota	ぺにょた
terii	てりー
ani	あに
mayu	まゆ
kitsuka	キツーカ
risu	りす
shiori	しおり
dagura	ダグラ
kawauso	ｶﾜｳｿ
morotade	もろたで
mimamiman	みまみまん
mikan yarou	蜜柑野郎
shiisaa	しーさー
ikuusako	いくうさこ
rato	ラト
yakimikan	やきみかん
linsama	りんさま
tanabe	田辺
saebi	さえび
momonga	ももんが
fudeneko	ふでねこ
mano rushia	魔野るしあ
tukamoto	ツカモト
hijiri	ヒジリ
tanapoke	たなポケ
kirinndou	麒麟堂
kakerun	かけるん
kotorin	ことりん
shikibu	式部
onikure	おにくれ
chiizu	ちーず
mikazuki	三日月
mashimahiroko	ましまヒロこ
bangren	バンレン
rikarumaranbot	りかるまらんぼっと
yuutokii	ゆうとき
nifunihu	ニフニフ
rekiko	歴子
moru	もる
yoshi	よし
nukoneko	ぬこねこ
kimuchi	きむち
umeneriasu	梅ねりアス
kamichang	かみちゃん
morimu	もりむ
shimaken	しまけん
luadayo	るあだよ
gachapinchan	がちゃぴんちゃん
miso	味噌
nanoka	なのか
safi	さふぃ
yuu	ゆう
haru	はる
minto	ミント
yaminoma	やみのま
riyoru	りよる
shion	しおん
imuncho	いむんちょ
ten ten	貂てん
adekasu	あでかす
kuroyuri	黒百合
mitsu	みつ
tabuchi	たぶち
toaruhonzuki	とある本好き
natsumin	なつみん
yaminoma	やみのま
akane	アカネ
sasagann	ささがん
nipponianippon x	ニッポニアニッポン
chapi koro	ちゃぴころ
horobe	滅べ
bakyou	ばきょう
ohanashimai	おはな姉妹
yuusan	ゆうさん
hotaruisi	蛍石
kubozun	くぼずん
kai	貝
mofuta keroryopu	モフ田ケロリョプ
rarea	られあ
toraya	寅弥
emuemue	えむえむ
skaname	かなめ
tamago	たまご
wakatake	わかたけ
negiko	ねぎこ
amixigo	あみぃご
kuropon	クロポン
yuzuki	ゆづき
hiramin	ひらみん
ushinobanicu	牛の馬肉
abiko	あびこ
miyuki	美由紀
seizenn	正善
fukutarou	ふくたろう
maddasana	まださな
konitan	コニタン
chibio	ちびお
hika	ひか
umeringo	梅林檎
toramaru	とらまる
reisuke	れーすけ
amaou	あまおう
pioka	ぴおか
nemurinekomaru	眠りねこ丸
natsume yukkuri	ナツメゆっくり
mugicha	麦ちゃ
nemurinekomaru	眠りねこ丸
kogumaitame	こぐまいため
saorin	さおリン
kobun	子分
shigi	しぎ
tapimo	たぴも
ani kun	あにくん
yuri	ゆり
piroriyuki	ピロリ雪
amaou	あまおう
maikun	マイ君
kazekun	かぜくん
aya don	あやどん
yakiimo	やきいも
asakawarin	朝河凛
satomi	さとみ
pokopen	ぽこぺん
harumai	はるまい
yukimi	雪見
unegiu	うねぎぅ
anmashi	餡マシ
itamimimi	伊丹みみ
ritsu	リツ
mauro	マウロ
kobomasa	コボマサ
aro	あろ
masarun	まさるん
hanten	はんてん
rirukuthi	りるくてぃ
takemura	タケムラ
purin	ぷりん
hareharej	ハレはれ
mame	ﾏﾒ
ohiya	おひや
asasennin	麻仙人
otubonnu	乙ぼんぬ
marion	まりおん
takumaru	たくまる
non	のん
simonetaouji	しもねたおうじ
nandemo ariyama	なんでも有山
haruchi	ハルチ
mirion	ミリオン
miffu	みっふ
ruukunn	るーくん
mikutoshi	みくとし
cheshuchi	ちぇしゅち
simatten	しまってん
saeki	さえき
hechima	ヘチマ
chibikuma	ちびクマ
mamasu	まます
riia	リイア
seira	セイラ
nanosu	なのす
kamonnba	かもんば
una	うな
mea	メア
riki	リキ
sasa yuri	ささゆり
sakamotomakoto	サカモトマコト
itazou	いたぞう
kururun	くるるん
shiz uku	しずく
azu piyo	あずぴよ
umi	うみ
pan panda	ぱんぱんだ
ashiro	あしろ
koto no oekaki	ことのお絵描き
tamayurakana	タマユラカナ
rio	リオ
rao	らお
hikari	ひかり
kabeko	壁子
sasa	ささ
tsushi	ツシ
kanau	かなう
miyaran	みやらん
yuutan	ゆうたん
potachi	ポテチ
harunohana	はるのはな
hinageshi	ひなげし
setsu	せつ
nopposann	ノッポさん
aoirico	あおいりこ
babu	バブ
hotate	ほたて
hayato	ハヤト
riohachi	りおはち
mamuru	まむる
tamago	たまご
keitaipaso	携帯ﾊｿ
umiushi	ウミウ氏
nyanyami	にゃにゃみ
pocha	ぽちゃ
kurimonaka	くりもなか
marimo	まりも
pirooka	ぴろおか
tsuyopon	つよぽん
genneitouka	幻影灯火
sakae satoko	サカエサトコ
risa	リサ
sassou	颯爽
taa kun	たぁくん
tukushi	つくし
minnnano meigen	みんなの名言
mizusyo	みずしょ
kirin chon	きりんちょん
tarouboumiyame	太郎坊宮前
atamaru	あたまる
mayo	まよ
wataame	わたあめ
suzuse	鈴瀬
jirachi	ジラーチ
bakashishou	ばか師匠
otoyan	おとやん
enomotoruku	榎本るく
kibanetunotombo	きばねつのとんぼ
mokepon	もけぽん
mowa aru	もわーる
kade	かで
misakienjyu	ミサキえんじゅ
darakou	だらこう
a	あ
yuki	ゆき
mochigome	もちごめ
miootorihiki	みおお取引
tarako	たらこ
pachi	ぱち
noko	のこ
atarashicho	あたらし帳
yakuruto	やくると
hotate	ほたて
kawai kanyu	カワイ韓愈
kaichaccha	かいちゃっちゃ
hirvenharu	ヒーヴェンハル
jikasei	自家製
maguras	まぐらす
tozakura	とざくら
norimaki	のりまき
riechin	りえちん
kassyokuha iizo	褐色はいいぞ
hatarak hagruma	はたらくはぐるま
ko suke	こすけ
momo ka	ももか
yokochan	よこちゃん
sakurannbo	さくらんぼ
kenken	ケンケン
utakaze rei	歌風零
hiyori	日和
yasuooz	やすおーず
kamon amerika	家紋亜米利加
ikesho	いけしょ
mineiyutaka	嶺井豊
hiro	ひろ
miffu	みっふ
kusuri tsuuhan	くすりの通販
hotatetarou	ほたてたろう
ruunann	るーなん
shiramizo	白溝
shizu	しず
zentudan	ゼンツ団
shirokuro	シロクロ
itatsu	いたつ
fenia	ふぇにあ
poko	ぽこ
chi chan	ちーちゃん
misae	ミサエ
shinomiya	篠ミヤ
ukigoromo	うきゴロも
shobon	しょぼん
osugi	おすぎ
punimaru	ぷにまる
suima	すいま
matsuri	まつり
hironohiro	ヒロノヒロ
ai keibafan	あい競馬ファン
takesshi	たけっしー
sukeberosu	スケヴェロス
madoka majika	まどかマジか
hiyo	ひよ
keteron	けてろん
harumi	はるみ
hechimaneko	へちまねこ
moko	もこ
rirukuthi	りるくてぃ
chiichasoo	ちぃちゃそ
arurupu	るるぷ
omochi	おもち
hirone	ひろね
akemon	あけもん
neriwasa	ねりわさ
araiwa	あらいわ
dodoguchisan	ドド口さん
aoi	あおい
kaba	かば
azuma	あずま
megu	めぐ
pina ki	ぴなき
aoi	あおい
egaononinja	笑顔のニンジャ
nahamukun	なハムくん
kotori	コトリ
jun	ジュン
aoba	青葉
haruka	はるか
hiro	ひろ
riri	りり
kitapaso	きたぱそ
rin poropon	りんぽろぽん
saki mayuge	さきまゆげ
takamo	たかも
ayanon	あやのん
tororo	とろろ
fenia	ふぇにあ
teto	テト
peporon	ペポロン
nekomikan	ねこみかん
xdarumasan	達磨さん
haru	はる
king kasu	キングかす
hachi	ハチ
saitojunki	齋藤潤樹
sakamotokosaku	坂本耕作
narumi nagisa	鳴海凪紗
hikami sakura	氷上桜
sakaumi	さかうみ
dokanmania	ドカンマニア
sirotama	しろたま
kinkin	キンキン
sanamaru	さなまる
nichiya	にちや
yumiso	ゆみそ
nazousagi	謎兎
iria	いりあ
haaachan	はーちゃん
asuka	あすか
haruno	はるの
chururu	ちゅーる
unagimentai	うなぎめんたい
koyayan	こややん
monakachan	もなかちゃん
yadon	やどん
azuki	あずき
potte	ぽって
hiromi	裕美
sakamaki	さかまき
keihan ekimei	京阪駅名
akari	アカリ
amameru	あまめる
marukai	まるかい
gokuraku  bouzu	極楽坊主
kohaku	こはく
sakura	さくら
ruto	ると
yukinatu	ゆきなつ
ruma	ルマ
isamu	いさむ
aik awa	藍川
okotaro	おこたろー
yozakuraayami	夜桜あやみ
kurasafuka	クラサフカ
runo	るの
yukimaru	ゆきまる
merika guraburu	メリカグラブル
rabitora	らびとら
gekikara	激辛
yuusan	ゆうさん
kannagi	観凪
pokatomosan	ポカ友さん
kyanon	きゃのん
kon	紺
riyo	りよ
takuri	たくり
sadasukekyun	さだすけくん
akemon	あけもん
moka	もか
bou ana	某あな
hana	はな
yaniwani	やにわに
ryom suke	リョム介
tatahai	たた牌
nukoichi	猫壱
tomako	とまこ
tonakai	トナカイ
asama	あさま
miroku	弥勒
nyon	にょん
chimako roku	ちまころく
takahashi	高橋
yamabuki	ヤマブキ
okotaneko	おこた猫
rokumai	ろくまい
furahisa	フラヒサ
yukikaze	ゆきかぜ
ichijou	いちじょう
kanata	かなた
wakoudo	若人
mega megane	メガメガネ
maatan	まぁたん
usa	うさ
minardi	ミナルディ
momomomoka	ももももか
kuuusuke	くーすけ
doramaho	ドラマホ
mikenekomatagi	三毛猫またぎ
oto	おと
kasutardo	かすたーど
jangoro	ジャン五郎
hiru	ひる
yahaagiii	やはーぎー
yumenomaru	ゆめのまる
toriipipiki	鳥居ぴぴき
shigure	シグレ
furahisa	フラヒサ
rani	ラニ
kuroe	クロエ
nna	んな
benio	紅緒
yofukashishimai	夜更かし姉妹
rura	ルラ
harunoto	はるのおと
takirousan	たきろうさん
sasakasi	ささかし
serirun	セリル
hinshi	瀕死
tsuchio	ツチオ
gochi uma	ごちうま
sai	サイ
takakenn	たかけん
neguse	ねぐせ
pero	ペロ
masakiyami	マサキヤミ
totutokon	とつとこん
shishamo	ししゃも
fukushimaginji	ふくしまぎんじ
shippoco	しっぽこ
kiri	キリ
kinnfuji	きんふじ
nosuke	のすけ
bangisu	バンギス
omochi	おもち
higahayato	比嘉隼人
satoumikiwo	さとうみきを
mi	み
asagirinisiki	朝霧錦
kuron	くろん
tomono	ともの
yukino	雪乃
ebicha	えびちゃ
futsun	ふつん
saku	さく
shitone	しとね
yukihiro nanaka	幸弘ななか
matsuki rina	まつきりな
kiramaru	きらまる
ginineko	ぎに猫
ruu katakuriko	るーかたくりこ
narusehironori	なるせひろのり
tegomegu	テゴメグ
kaze	かぜ
mekara gobou	目からごぼう
chonchon	ちょんちょん
kimuramurasaki	木村紫
canachan	ｶﾅﾁｬﾝ
furahisa	フラヒサ
ayato	綾斗
ruchaan	るちゃん
marein	まれいん
kanami	かなみ
yoru	よる
rekigan	れきがん
kiyu	きゆ
fujiminoru	ふじみのる
mano rei	真野怜
soo mei	そーめい
hokke taso	ほっけﾀｿ
yuu	ゆう
umako	うまこ
reto	レト
tentaro	テンタロー
tomoka	ともか
dokuro	どくろ
tamagawa okera	多摩川オケラ
mamikimina	なみきみな
yamineko	やみ猫
kona	こな
anzu	あんず
shimizu	清水
idekaze	いでかぜ
yukimaru	ゆきまる
ruko	ルコ
ore	俺
shinjisensei	シンジ先生
okamurasan	おかむらさん
aokikenichi	青木健一
monki	もんき
yuto	ゆと
takasaki	たかさき
kikkun	キックン
emihasi	えみはし
ginto	ぎんと
uraken	うらけん
pokepoke	ぽけぽけ
uchimomoniku	うちもも肉
nano	なの
enukko	えぬっこ
pokepoke	ぽけぽけ
fuwa	ふわ
mori shou	もりしょう
ani	あに
hiina	ひぃな
mo naka	モナカ
machimi	まちみ
aporokiki	あぽろきき
usagichan	うさぎちゃん
nemu	ねむ
syougun	将軍
gauten	がうてん
geboku	下僕
sayakak	さやか
mahusukaya	まふすかや
ijiraregakari	イジラレ係
parukya	ぱるきゃん
yamatokkou	やまとっこう
maria	まりあ
mutou	無糖
tadachan	ただちゃん
tenchijiyujin	天地自由人
masakari	マサカリ
tarutar	タルタル
ukikusaa	浮草
okei	おけい
taimeshi	たいめし
yuhtatsu	ゆーたつ
rarirulen	らりるレン
bokenoko	ぼけのこ
yojisugi	よじすぎ
matuyan	まつやん
koha	こは
kuma	くま
ame garo	あめがろ
uchi yaki	うちやき
amanao	甘なお
ma burusando	まーぶるさんど
totanpa	トタンパ
asure	あすれ
esa hoisa	えさほいさ
yurara	ゆらら
momo	もも
naruseyuu	なるせゆう
nemutarou	ねむ太郎
pafferupafe	パッフェルパフェ
akame	赤目
tolyoaki	トョアキ
dtomonowa	友の輪
mayorun	まよるん
natane	なたね
ikuchan	郁ちゃん
mariru	まりる
ouka	桜花
hari rura	はりるら
minagawa aoi	みながわあおい
sitosama	しとさま
nomeji	のめじ
niwatun	にわつん
gudegude mama	ぐでぐでママ
saeba	さえば
baru	ばる
miya fushi	みやふし
sonnnakoto nai	そんなことない
sakyo	サキョ
kaho	かほ
pikasan	ピカさん
ebi nabe	えびなべ
kazu	カズ
hakunetsutitai	はくねつちたい
garurun	ガルるん
pappurin	ぱっぷりん
fumiemon	ふみえもん
terumi	テルミ
watapan	わたぱん
kamo	かも
jorako	じょらこ
kikirinka n	ききリンカーン
mei	めい
inazumakoto	いなづまこと
ochataro	おちゃ太郎
hanamin	ハナミン
maikacha	まいかちゃ
nasu	なす
natsu	なつ
palutena kopipe	パルテナコピペ
pan	ぱん
tabigoma	たびゴマ
kiku	菊
shirono	しろの
kirimu	きりむ
risa	莉沙
maotarou	まおたろう
shoooya	しょーーーや
gokuraku	ごくらく
nakano junji	なかのじゅんじ
usat amu	うさたむ
arufo to	アルフォート
kitapaso	きたぱそ
aki	あき
yoshi figaro	よしフィガロ
mizukame	みずかめ
sasago	ささご
wasa	和佐
magaru	まがる
kiriyouwa	きりよーわ
haruka	遥
kemonar	けもなー
rokushin	ろくしん
oujyanotamashii	王者の魂
heiwanoryuu	平和の竜
kairakushugis	快楽主義者
ki	き
faru	ファル
muu	むう
tsukiyura	つきゆら
syururu	シュルル
kuma	くま
sennou mebae	洗腦めばゑ
hitorimip	ひとりみ
ebikani kirai	エビカニ嫌い
miyumai	みゆまい
huwanekko	ふわねっこ
roku	ろく
kuraima	クライマー
manekichi	マネキチ
manekichi	マネキチ
koroku	ころく
koroku	ころく
kakiotu	かきおつ
ikaten	イカ天
tocochin	とこちん
fuyunonami	冬の波
haraheri	はらへり
suzumisiro	すずみしろ
suzumisiro	すずみしろ
ebikani kirai	エビカニ嫌い
kani	カニ
ebikani kirai	エビカニ嫌い
ebikani kirai	エビカニ嫌い
bunta	ブン太
nagi	なぎ
katakuri	カタクリ
akatsuki	暁
sasasuzu	笹鈴
inori	いのり
denden	でんでん
yamanek	やまねこ
ro puru	ろっぷる
onakasuita	おなかすいた
ro puru	ろっぷる
yanagizaemonn	柳左衛門
kodama	こだま
kodama	こだま
onakasuita	おなかすいた
yanagizaemonn	柳左衛門
yanagizaemonn	柳左衛門
onakasuita	おなかすいた
ro puru	ろっぷる
kodama	こだま
shiori	栞
kosodemochi	こそでもち
potepokari	ポテポカリ
potepokari	ポテポカリ
haruneko	はるねこ
haruneko	はるねこ
higerinn	ヒゲりん
higerinn	ヒゲりん
tomo	とも
kusabi chan	楔ちゃん
tomo	とも
kusabi chan	楔ちゃん
teru	てる
teru	てる
teru	てる
ba bamiya	ばーばみや
yananan	やななん
shinakun	シナくん
uguno	うぐの
furifurimomo	フリフリモモ
makarou	マカロゥ
nekoteru	ネコテル
aida akira	藍田彰
hinata	ひなた
yukinko	ゆきんこ
kunntaka	くんたか
ranoka	らのか
fumikun	ふみくん
maurora	まうろら
guriguraburu	ぐりグラブル
komakoma	こまこま
hotochan	ほとちゃん
makitoma	まきとま
ippei	いっぺい
kimako	きまこ
osusumepanda	おすすめパンダ
boushi	帽子
mizu	ミズ
ootake	大竹
nekokan	猫缶
rande	ランデ
sharinuki	シャリぬき
kagerou hiyori	陽炎ヒヨリ
morikou	もりこー
murakumo	ムラクモ
ebikani kirai	エビカニ嫌い
warakarabe	わらからべ
tozamasan	とざまさん
hayasaka hibiki	早坂ヒビキ
migites	右手
yumechan	ゆめちゃん
monoai	ものあい
mouroku	もうろく
yu tamagosan	ゆうたまごさん
kyao	きゃお
kouhaku mochiko	紅白もち子
hitosazi	ひとさじ
tsudamakoto	津田真
asahi	あさひ
minomaru	みのまる
hijikitune	ひじきつね
shinopom	しのぽん
touji	冬至
piroki	ぴろき
nana	なな
tsukacho	つかちょ
charorinu	ちゃろりーぬ
himagami	ひまがみ
ai	藍
pokemonkoukany	ポケモン交換用
tobi	とび
namamii	ナマミー
rushius	るしうす
mitsuki	美月
satowa	さとわ
aoi	あおい
kani	カニ
hanamaru	はなまる
watabou	わたぼう
maechang	まえちゃん
maton	マトン
omega	オメガ
oyukima	ゆきま
kurage	海月
serori	せろり
nyankomama	にゃんこママ
hikaruki	ひかるき
yukemuri	ゆけむりぃ
aoi	あおい
taisan	たいさん
usat amu	うさたむ
mizuki	みずき
furuponi	ふるぽに
kiki	キキ
eipontarowo	えいぽんたろを
tatahai	たた牌
annin	あんにん
kabulera	かぶれら
asapinn	あさピン
fuuya	ふうや
kochiramuisu	こちらむいす
yua	ゆあ
yuri	ゆり
ringoame	りんご飴
reina	れいな
puuma	プーマ
daiya nyago	ダイヤにゃご
kemonar	けもなー
juda	じゅだ
mimiyo	みみよ
nodogoshi namax	のどごし生
hanashiro	はなしろ
okiro i	沖ろい
tenekura	てねくら
rei	零
chandai	ちゃんでぃー
pipikichi	ぴぴきち
harina be	ハリナベ
hisa	ひさ
masa	マサ
kabuukon	かぶこん
irodori	いろどり
hina	ひな
shiki	シキ
neko	ねこ
mayu	まゆ
tonkun	トンクン
morinotakashi	森にたかし
miyuu	ミユウ
naokinoran	なおきノ乱
megumi	めぐみ
teruterunoumi	てるてる乃海
dachin	ダチン
masuni	ますに
mika desukedo	美香ですけど
pokoteng	ぽこてん
yashiro	やしろ
hato pato	はとぱと
sakuraomochi	さくらもち
tsuchio	ツチオ
koroku	ころく
aumjikenkaimei	オウム事件解明
gyakusyuu	逆襲
yamiotiharuna	闇堕ち春奈
mikarin	みかりん
momose	ももせ
hotate umaiyone	ホタテうまいよね
merankorikun	メランコリくん
hariganeshinsh	針金紳士
donabe	どなべ
gotoizumi	ゴトウイズミ
yuzuki	ユズキ
hosineko temari	星猫てまり
horohoro	ホロホロ
kanata	かなた
omochi	おもち
katsuwo	カツヲ
senzai	せんざい
pokua	ぽくあ
rori ze	ロリーゼ
sharon	シャロン
hakomaru	はこまる
yatukino	やつきの
tana ppe	たなっぺ
osero	オセロ
ichamonten	以茶門天
kuwaaaman	クワーマン
kago me	かごめ
hanamaru	はなまる
tanakapunie	田中ぷにえ
akazuki	あかずき
harukanata	ハルカナタ
rokumaru	六マル
shimamuu	しまむぅ
liropika	りろぴか
uni ikura	うにいくら
yuyu	ゆゆ
warabi	わらび
tukiusagi	つきウさギ
kuuhuku	くうふく
wao	わお
sakachan	さかちゃん
kuwaharagao	桑原ガオ
yumesaku	梦咲
himawari	ひまわり
tana ppe	たなっぺ
jikaidan	字怪談
tozamasan	とざまさん
arekku	アレック
futamaru	ふた丸
daifuku	だいふく
omiotuketarou	おみおつけ太郎
kitashiro nagisa	北白なぎさ
ouka	桜花
mon	もん
tana ppe	たなっぺ
yamabuki	やまぶき
pon chan	ぽんチャン
haneta	羽太
yasaka	やさか
rizu	りず
o mochi	おもち
bide	ビデ
mitsuha	みつは
