ragabsalim	رجب سالم
lliixi	طيف
Azxd	أحمد
GLAM_SANAD	قلم سند 🖋
Ben Al Sahem	بن-سحم 
ibraheim	إبراهيم.
ladyfatend	فاتن faten
TggAhrdg	الهدهد
nn_	ن ن
Amani_	أماني'
Safiahi	صفيه
AlBattar	البتار 
AlBattar	البتار 
hmanii	حمني
Abo fiesal	أبــو فيصل
ASaadi	احمد
i NeeF	نيف
majed	𝑀.ماجد
midasv	ميداس
jamal_malallah	جمال مال ﺍﻟﻠﻪ
alnahoarabi	النحو العربي
majed	𝑀.ماجد
jooorre	جوريه 🕊🎻
hamadsalemnaser	حمد سالم ناصر
abortal	ابومشعل
mohd_hudaib	﮼أبوهديب
memem	مريم
moath_	معاذ
sajadh	سجاد
alanoud_	العـنـود🦋
adnullah	عبدالله
sajadh	سجاد
behindzascene	 بالعربي
albtl	البتول
MAHMOUD	العاقل
hmms	همس
hamadsalemnaser	حمد سالم ناصر
SalimSalemt	سالم
DqSwJXVQssVG	سعودي مخلص
Talal_alharmali	طلال الحرملي
jkore_q	جـكـوري -
watenalqalb	وتين القلب🤍
DqSwJXVQssVG	سعودي مخلص
baghdad_	﮼بغداد
samr_alareefe	سمر العريفي
yazeedalbusidi	م. يزيد البوسعيدي
JEEDO_	مجيد
faisal	فيصل
faisal	فيصل
te_xr	روز.
jinan	جنان
IBasim	باسم
IAZ	عزيز
lliiss	لمى
Ammkalfl	الفحل
Safaa_alOom	صفاء 🇯🇴
siuii	ساره
Albarjasi	ابو برجس
ifarah	فـرح
mahdyalghazal	مهدي الغزال
Ben_Al_Sahem	بن-سحم 
mlk_oun	ملَك.
KBamboog	بامبوو
M_almo	اميره ~
Madlen	مادلين
bandaralhrbi	بندر الحربي 🇸🇦
iihatoon_	هَتون
UmUrubah	ام عروبه
Tahalowi	طه لؤي
boooonasar	بو نصر
HindAbduaziz	هند عبد العزيز
berdnajd	☆طير نجد
thekin	ملكي
IMxvjWCUAUsQf	بوجراح
basma_saif	بسمة سيف➰
wteen_alshehri	وتين الشهري .
mohammedl	محمد
ndBpTMgcyjDxP	بنت الجبل
Khalil_Alshaeri	خليل الشاعري
nwafallfaredi	نواف الفريدى
naserteacher	ناصر عباس
jood___	جود
almourgi	الروقي..
xrar_m	زمهرير
iirujr	ناصر
Sam_Samia	السمو
ssssssql	سِقم
narain	نارين
saadabokhalid	سعد بن ثاير
ssssssql	سِقم
alwalid	الماس
KzzO_	Skz.
a sl	عادل
DanaAlabdely	دانه العبدلي
saz_x	سيدرا
ssssssql	سِقم
ssssssql	سِقم
sultan_iu	سلطان
almaleekaah	👑الملكة👑
ofo__	أفُــق
jojosaad	الجوهرة
sultanhn_	سلطانه
ELOMDA_	العمده
walesd	وليد
walesd	وليد
B Almas	بُشرىٰ 🕊