X XZ WN B	蜜桃
reiu 	零
 iyumeko	安和梦子
A KA AA C	A KA I
Atticus	Atticus
eryu	耳語
f RM QSgo Ov	穆兆洋
h OE Pv BYmut N	留园的风
forevertjt	T JT
X XZ WN B	蜜桃
Ninja Zyd	阿瓜我爱你
L Uvjn Uatbvgc	火柴盒
Kinky Horny SM	春小叔
Bwl XYu BKdi QI	天空
Hys Thomas	トーマ@わぐらぶ号
Xiaomeng mimi	不會聊天萌
O Ffuty UU Rv	青梅灰鷹
Asifmehr	Asif mehr
X XZ WN B	蜜桃
dolloftwit	おバカ人形
cxksxf	温宇
V TD Qs Xem RB NTr G	亚博体育课呆呆
douyin H	抖音 H
 Qiudong 	球动
maobaoxiaoshuai	小帅猫
adkmne	灵儿
Desmond Hamm	戴医生
Mhig Wakne DZyk	龙阳帝君
ti QN Gb NE IHc Ix	胡桃夹子
wangdavid	猛火龍
yangyifan fan	◥◣凡凡◢◤
us Aa XAge Jf Bx Ob	窗下西瓜
Lushanzilong	庐山-紫龙
shuiqiuhan	水秋寒
model BO BB Y	裸模 BO BB Y🔞
H AD A another	H AD A
chenlive	陈彬彬
algiz	Algiiz
X XZ WN B	蜜桃
tiantianovoo	我超甜的
Anastas	Anastasiia
ox NSsh Kkjcwu MP	Prisztug
Lushanzilong	庐山-紫龙
hirokimi	H次郎
foni trung	Foni Trung
Ancc sm	Ancc
Akilli Delos	Akilli Delos
X XZ WN B	蜜桃
nagaikei	澈
little angel	小天使👼
wg UEw RH Spzfx	阿斯顿
Chingtian	晴天☀️
ple pna	Ple(P NA)
dqamjhn Jp Ttgz	尽凡
z Zcf QHkhd OF Kl	古灵精怪
 yikiyomi	萝莉酱
Sweetie Balloon	Sweetie Balloon
simalayasan	simar西瑪
Atyok R	歲小弟弟
S BS Rikrrboo QP W	搂住！搂住
 yikiyomi	萝莉酱
Bryan	Bryan
wanwan	晚•
Auradee Aur	Babykatui
linjumming	麟峻銘
wkzaen RL VLk L	独孤栗子
xiaoxingbrother	一根稻草
dqamjhn Jp Ttgz	尽凡
Pangping	Pangping
K Hko Bc XC AGg	岳岳
wolfgangchuang	台南小次郎
Alfonsoorg	Alfonsoorg
M MPower	T.L 👊👊 👊
S Czp IV Bpj Vqj	非黑即白的光色
kmz Nq FX Pa AH	龙口西的王
uglybobangybob	Bob.Yao
himalayajsxj	就是先进
Kann soccer	刊
anbt	Anbt
Titans	Titans
Payne	Paul
Double Fake Cute	多戲超人
huangxiaohao	勇者的木棒
childlike CToao	倉冬
vy Ijoymogb	真相搬运工
Carnal Couples	Carnal Couples 浪蕩鴛鴦
Anhhm	Anhhm
balibalihon	黑匣子
Passion Times	Passion Times 熱血時報
likeilei	怠惰な猫
Loveaimer	蛋頭
L Th MLin	An Ciu To
Akira	Akira
Pangping	Pangping
ple pna	Ple(P NA)
G FWfrog	墙国蛙蛤蛤🐸
youweigu	云烟客
northnorth	有北
Agent Kwok	車尉
R EC ON GU IS TA H K	R EC ON GU IS TA
sxy	伊敷eave
Tiaoi T	啼啼ᝰ☘︎
Tim	Tim
Jayson	森骏
Peachcoconut	P EA CH Eee
xuanjiyu	魚玄機
twiterrr	Ra Pp Ap
jerry	爽爽
V II JW KK J	矢澤 にこ
X XZ WN B	蜜桃
r MC Ob RR XYx CC L	遇见骚人
X XZ WN B	蜜桃
h BRnxyr LT D	宇宙神偷给爷爬
Aimer Ssan	萌阿珊珊
I IU MPs Gmt ZT B	突破寂寞的哥都月ʕᴥ• ʔ
yume 	宇夢
tianchaolangren	楼凤浪人
m FRuvm Bo Rf TV	泡泡
Huang Fuping	C皇甫平a
Marcost	Marcost
Tulhin	Tulhin
Ahmetistanbul	Ahmet
ywrito	齐季
Aaronch	Aaronchu
w Xaao ACwjj TH Hq B	霸道小爷们
ika  kichi	魷吉/イカ吉
b DVm Uubq Yv FN	张清松
E Nrf CO CL LH YZ	左亚兴和
x Ch Jy JFwv KV Hv	辣椒炒咖啡
jil RL Zk Spgf O	举小白旗
Xof QUm Uvz GK Tf	如果你也愛我 💋
L Astatine	Astatine
Radiant HK	池沼
wheein be happy	又多活了一天
doooiny	杜恩
takedownevilccp	画☘️画
chinanewsbot	中国新闻
Bob Chen	Bob Chen
K GP Jcr NLx Xb Eo	仙仙
cestlavie	D C Top
Jtko Az JI Oujl B	不时常的日常
Ako	Ako
Ne Lson	呢到五個字
notesnword 	類🎀三麗鷗的盤子
B Dl Anw TV Fu U	蔡奇軒
hardstyleme	i Am Hardstyle
wangseng	王胜
solafuxiao	Sola拂晓
jordantan	Jordan Tan
F KM YG FF	Kawai「互」
T HY	🐝T HY🐝
Aung Myo	Aung Myo
Taufufah	Taufufah
sumiko aymy	王茉莉
kosenaoki china	古瀬直輝的應援帳號
Adgerrrrr	Adger
dangsangwangbo	宕桑旺波
Bao	Bao
y AQ QNk Zm YQxn	逢卿先生
A DO BN	A DO VN
daijiali	欲（互私）
Eppj ffjh	咚东
P RW Mry VEv Jut IH	希望没烦恼
bdy DX JQ GE Cg GYl	雨辰
j VDzzuvfgc FH	长沙小包子
shangxiaqixin	上下齊心
xuechaigeng	柴梗
Alfred Mills	Alfred Mills
shiroijusu	纯白果汁
igr SY OT Jr RG CIb	爱神巧克力
Vic Weeb Anticom	So be it A NT IC OM🚁🤸🌊
D GXjgg Ws Cx JM Cf	林深不见鹿
Autumn Voda	Autumn Voda
Ji Chou Xiao Guai S	巨怪
m Ntc Ljujs LXj	刘辉
azertac chn	A ZE RT AC China
je Yek CJ Lhp Pq	黑夜
Anyu WH	Anyu
Buy BT SBuy	韜光養晦💜
Taipeisuitbear	內褲控🐅台北
gxe ZN Jr XI UJ	农民兄弟
z LY PGyr ZVtz	夏翊
Khun Tong	Khun Tong
yanikibot	ヤニキ Bot
Qiang Xu	Qiang Xu
govievpjst	猪猪
Niusmdaj	Biubiubiu
D XH HK A	小花花
T AL ES	L IT A
shikatanori	王磊
govievpjst	猪猪
Saiki	齊木難熊
d Iz Qt VZ HDjx	岐安安喬
T WI NK LE TI ME	T WI NK LE.T IM E
chair	龍騰井
S PKarakuchi	カラロ君
Jumbo Ansom	劉子龍
biokid	Biokid
zhiyuan monkey	侯志轅
Qiang Xu	Qiang Xu
xif Qyl Et Bvw	豐原狼 不差
Aak Za Ou Dv Wu P	我要吃奶
Tomy King	Tomy King
j Jsf Xzt TNsag	多毛狒狒
hasugaruneko	一隻貓子@Twitch
edwarde	仕麟
rakragrandma	雁➡💛💚
Mayflower cn	五月花
Gua Ruaa	一只呱。
T AM A	T AM A
v Sngu Lww VY Xb F	牧奶伊
Papapa	Papapa
B KQ HV Efi QG MB PN	杨志宇
dfjdxhw	leo 弟弟
munetakabot	音速のソニック
B KQ HV Efi QG MB PN	杨志宇
huruyunfeng	虎入云峰
B Better	斯蒂文
Aozaki katya	💕Cervix Penetration💕
govievpjst	猪猪
Andrs	Andrés
Bfwj LD Ckpuo	林子明
g Zvcwj DQ Cd If	嘤嘤嘤
mys tx	苗子猫
Tonycha	Tony chan
Vic Weeb Anticom	So be it A NT IC OM🚁🤸🌊
fupingpiaobo	小狐狸不熬夜🌙✨⭐️
umblx Yf Ez Vdk Lm	我是西红柿🍅
wendy	芙🎁
B Better	斯蒂文
C BK	C BK
G MPing Lun Y	公民评论员⁵
fw QYts Ro T	翻轉......
W ON GK EE NY	Keeny Wong(意无怠)
Asce	Asce
fw QYts Ro T	翻轉......
Shino	小泽
fupingpiaobo	小狐狸不熬夜🌙✨⭐️
fox nc	雄浑
Takehiro Wei	Takehiro🌈威
Pinkqueenchoice	Pink Queen's Choice
Jojoe XX X	D AN IE LO . (+ K) 🔥
linjumming	麟峻銘
sayoharuharu	小夜 春々
bailiusu	白流苏
Red Pandas	Red Pandas
Tom	Tom🌈
Oj ATvnpzh Jv	🍀赐福
Yale Alexa Tony	Yor K Balamaraga
Ge Ki Kkfh DA	我的脏袜子
jy Kekj Fi W	泰拳刚猛🇹🇭
T Bol Ty AUiokc P	收正装中年
A YX AAl Na Je	碧海潮生
Zrt Ax FN PMp L	宁波主收奴
Ilp Hifxsz EYm Su	原野小年
blablaxiu	blabla咻
k r n o	我就是這樣
setlivenews	三立 LI VE新聞
Tohn	Tohn
nn OEy Dywkby CK	水竜
Ae Drueet TL Oh J	直男荷尔蒙
G Vsm Dw LXe	一只白羊
xiaotaojiang	小桃酱
hpgq YKa Sqa HJ	苏凯佳
Di Bao	Bảo kun’s
zhuzhuchuanmen	🇨🇳珠珠串门
B TB T Qin	B TQ
niushiba	牛十八
cmy Mv CLi Rl Qdz	已婚人
S SS Y	Yin Sun|孫寅
Fengsiyuan	Mr.死因
emanon eruri	𝔼𝕣𝕦𝕣𝕚專用號＠
Hnlinayi	琳姨太
doudoudewou	小兜兜
jy NM WN Pl YX M	李宏建
qnfp Cho EFw Tk Fu	淮安洪泽的妹子看过来
abcdelittle	小小葛
 Sakana S KT M	Saka魚†┏┛墓┗┓†👠⛓💉💘🧬
xiaomizhou	小米粥无糖
Z S Piper	🌵薄荷棠🐨🐰💙❤️
An Hel	An Hel
Sky Hurt	颜子航
Yd Qie HA TY Fj QU	医院快递
Ei Bee	Ei Bee
q Dry KLvp Dw H	乐乐
Y WH ENe SB Ay	墨者
Trel Snow	Trel Snow
light hide	渡島英秋
Liu Xiang Yong	Liu Xiang Yong劉祥永
yq Eqm YCxn Pj	冬音
P Bear	P Bear
Taxuewuhen	踏雪无痕
Bittermelon HK	Hanko Bittermelon
muzhige	木子哥
Ff MD HE Jbz SIx	M G战士
Daily China News	中文新闻
m ZG Cw Celjj Sg	种花家的小船🇨🇳
xinzhaoyiseng	欢喜密探
H SB C H K	H SB C Hong Kong
True Nd RE AM	地万ㄇㄇ
hg TWfuou KF Kd LE	关老爷
Rose  Jack  	蘿絲傑克
Fieland by 	Byrd Fie Thailand
Miles Frezzo	Miles Andrea Li
guzhongzhen	大古
k Vp ZKf EL RV BR UA	天地良心
A S Apple Daily	蘋果日報副刊 果籽
wamei	袜妹妹～
c Pbnbd NLt TFd Z	小黑黑
hu lalalalala	出埃及记
yayiaiaiai	牙医爱爱
iyo miyon	伊豫乃みよん
Tired	Tired
Fxbtg O	F XB TG
lmujian	老木
Her Bai	张旭
timeschina	中華時報
sexsusususu	苏苏学姐
Cq Gy NG Nl Us Xn G	力拔山兮气盖世
Airfira	Airfira
Adi	Adi
Bye V	Bye V
B Bmonster	B Bmonster
lzcnxmh	長爷名征
P KU B X	B X
L YA SM	A D钙奶
n YH BCjx NIug FT	汪先生
Ca Alexc	熊大🇭🇰
runawayfromtheh	疯越飞人院
R EC AL L	R E:C AL L
Betty Box	Betty Box
grace	晓芸Ｈ
Annastasia 	阿娜斯塔西娅
Blair Hannya	Hannya Blair
o Axq Pe Qgwwvt F	无聊大师
Aliexpress A	H OT S AL E
nv Ys UHo YBfo Ev	光明恬淡
kuuhaku VN	Alex VN
Ec QR VT OE Ln Aj B	刘成龙
tangguolili	糖果粒(互推)
bilidilimi	哔哩滴哩咪
God Bless BP C	Amazing
Jq WJg IKn Lj H	三字临虚
Rux RNj Pz	沫河口
gaojun	寂冷
taishiandlovu	Tai Shi 扑神史少
wamei	袜妹妹～
Dr Wf YU Adoro	杨怀斌
Angekang	K.A.N.G
be xiao	Xiao Be
huangfandong	黄反动
uc DJfayc LKu	大宪章
Salvador Avila C	Salvador Avila Corona
Ehkwe Srcg W	夏天的风
kgajnjan	小卢是个橄榄绿
J J	深圳 JJ姐
S IL EN TW OL F	我不爬了 Eeveew
Tsukishima zero	🌸優花花花花🌸
I AD ND Bqgw Xl BF	小傲丶
phyton studio	Phyton studio
Plaalisa	Plaalisa🐱🐯💛💚
Abs	Abs
J Zx Sf Zjg PK	黄蛋黄
brandyot	Brandyy♡
liangqinga	厨娘、
heizemeiko	黑沢美空
Fiend Gaming	Tre
Zh IO UPti Bkz FB	傲血小松哥
yzt Cttqouq	网调主
Anti China Wall	推倒防火墙
caikun	H星落
ha Ol Nf LY Zc Cr E	達卡你
C NF ML MH WZ	觉醒的访民
Corning Tucke	看圖用
Albert	Albert
beimeiduoshou	美国剁手
Cave of Winto	沒有喜歡
aavps	A AV
Anati Amir	小琴
Wu JJ	哎你好
Carlos P	Carlos Payne
z Zcf QHkhd OF Kl	古灵精怪
n KM Ou Sn Bsuen D	魁鸿钧
hda EWmyu Pjs Q	塞纳河边的渡鸦
hda EWmyu Pjs Q	塞纳河边的渡鸦
xiaoniaojiangyo	探花系列（持续更新）
shrink Sean	王时敏
tanggulashanzei	唐古拉山贼
hechima 	🥒瓜🥒
irvinedai	深潭
Huiye furry	辉叶
sakura Richard 	疯狂的外星人
Croro Kie	 💛好耶💚
natsuki	夏樹なつき🐯🐥
lijuxia	猫本猫
Iogito	Iogito-耀哥
J	過往雲煙
V FNh ETn KBt DPym	酒迅
Z Ev GH Jjex KRk Cu	一路向北
Li Ying 	李颖
zhuxiuliang	朱修亮
huruyipekin	胡如意
Hnlinayi	琳姨太
Baoshoupai	砸锅反共
xbblxmg	鸢先森
Aden	Aden
jackylee	近况好吗?
lovebtsnkm	橄欖油
tryandloveagain	I A M N OT A BE N T
Fbm Qqb IQ FNtj J	龍之心
icyivymilk	跛豬💓
Bobking	Bob king
Tom Chen	Tom Chen
baetherson ian	Ian Batterson
Aden	Aden
v PP Dp Mupv FS GM	谯城耐久
t Eg Zbn Zl TNm IN	城子
wrygyuitlalvunr	一针见血
Bary	Bary
gw Lcit Nief PL V	星星點燈
jakdanbeile	屁虎的
Pitiful Servant	Pitiful
xingyinxiaosao M	夹你大鸡鸡
blossom 	Qing🌷
luoyanghanzi	牡丹花下
ghtandyy	Im网神
S WN HT X	花同学
gmkuayxl	K UA Y X L V.
j Ppcq SJr Wha Y	君见见
Awakening	Awake
shangxiaqixin	上下齊心
Njt QM DMinbovu	L SP明月哦
A Lee	A Lee
x Rpre Wo XE QSyyt	是妍妍哇吖
Awakening	Awake
Amelia Q OOb	Amelia QO O
Player rugbyboy	Player!ラグビー担当🏉
C Rin Ip TPf Vy Pn	推信微特
S MA LL ME IK ON G	♠️Blacked Asuka♠️
yeyuan	风行
gaiboyang	改你妹
Y Clove Bang Tan	歪西（暫 RE ST🥺😢）
A DXz QFygx Ifb	正装s
E Tj Fx KI Ire OR J	一人之下
zhuanyan	转眼
im YU Lbxmw KX Nd	久保俊明
I am PA P	现役小污井
World bb Yogi	Rest Aust
dedydedy	灵唯
chang	莫默
slumptenks	Alex
luoxiaohei cat	罗小黑是猫咪
kingliu	刘
B IN	B IN
nkimo	壞老爺
Jinjiumaon	津久茂ココア
B Oi Llpkh UJb CH N	水里的猫
Josh Lee	Boi Boi
Lp BTg Zzxk SO OT	天道
Cng Tr	Công Trí
Cauary	親親吾愛
C HX IA	迟夏
Z J	yy同学
f Nzel Lo Rt UFy G	小灰灰
Nala Ginrut	卖内裤的大叔
Yt VXhs Bh VG J	王智勇
Zccm Qr Yu RS	马克
y TNz DI Cmnsoq Xu J	神仙
Chinese X U	君子中庸
athena kwok	Athena Kwok
caonimazhinazhu	野獸先輩習近平
shosx  	三二八､🍵
erocosplayz	Erocosplay Jiaojiao
nuannuanmei	妲己
Jk EQ Wq QX TMb KZ	靓仔
Ssssxxxjj	沈相杰
Cauary	親親吾愛
y NH Ic Zz Es AVbmv	青山绿水
Dao Gao	黑黑
Darkrain	暗雨Ðáren✨
Toppytop	Toppytop
iqs PWu HF GTgx Dc	晚晚晚
Kizfkm Mwv Ah Xjrj	乡下人
shilinfff	Loyal丶
G XKmme Ut Ph LUc	机器猫的口袋
seo bb 	B B
B Bbird	爱吃🍓和🍊
Cauary	親親吾愛
danielwong	四爷
Cauary	親親吾愛
kennytseng	Kenny Tseng
Arlene S	Arlene Sanchez
Iogito	Iogito-耀哥
cccgeorge	維西尼
liuwenjay	劉、文傑。❂
jy NM WN Pl YX M	李宏建
H AN A	H AN A
rxin	山河
kingsex	A. Y.
Y ZKa Fown SAqmf	我自己
k Vktpf Wx Pe	周泽
Ahar	Ahar
xiaoxiaoyu	小小雨
kungjimbo	肖丸子
Twt Video Of China	推特影音中国(T VC)
fupingpiaobo	小狐狸不熬夜🌙✨⭐️
N HW Ioyge NEcgl B	跟随教练
Th EC Rack ER Ba Ro N	𝓜𝓪𝔁. 𝓓𝓲𝓮𝓰𝓸.张麻子
twducky 	嘎嘎肉羹🌼
Ls Zoe	石木刘
Z MG H	走馬觀花
versbtmsexslave	騷穴性奴
Lucky SE VE NT EE N 	Lucky SE VE NT EE N
Ze Xbn DL Jvg Zh	林骏杰
xuge	徐歌
qingdao	青岛➕qq
helmour 	吸吸𓃦
daweijueye	伟爵爷
bitingcishets	Z A R A
Tav	Tav 
Ilovehostage	斜陽の紫陽花
H C Littleworld	玩沙夫妻
ec OJ Ap Mn Nznp P	东方木
y Jc Cy CNwn Vceh	嘘安静
longyang jun	龙阳君
Pandith	Panditha
M UY I	木亦
L EE Bear	L EE Bear
u CI EC Mubeb Xv	胖胖胖先生
qingdao	青岛➕qq
w UY Sticmuxle FU M	流年
huixuanqu	回旋曲
x Eymk Rism Yz	風中微塵
hotteokk 	糖餅🍪
Yg SXfl ZMpg N	稀里糊涂迷迷糊糊
Stormstout	风暴烈酒
Z ZWv Qo Zpvm OG Je P	千绘
yuelaozaixian	月老妹妹
lishaoxuanli	行不行八点半
hymall	马卓
Myo Aung	Myo Aung
C HX IA	迟夏
chenkunnan	原始人
Q LC Kg Mlxj HS N	都不睡觉在看
kembaliannongfu	羊驼崽
Thuan Vo	Thuan Vo
u Vx Fv Vzjwng M	大哥大嫂过年好
okthkg	性癮學長
A LU U	A LU U
lushuwen	魯啦啦
C QY FK MRnh ZRyx	老三
R AH UL	R AH UL
with Huang Qilin	「W IT H L IN MO🌲」
real Lowpayman	低給料青年™
Fickle Berries	Fickle Bee
A UU	优优
b BZk PEx NVm JSev	E.P B OO M
ixmonika	Bill Carson
Blor	Bálor
fu TRpu Mgcx KJe	韬韬韬韬韬.
Salllllty water	鹹水💦
usagiai yani	愛香💕坂田家🇨🇳
Phan	Phan
Hallo Mr Song	及时行乐-
aldim	Aldi
heizemeiko	黑沢美空
A Xb Zi Rx Pf Dta N	叶辰
hapihapisultanz	ハピハピ皇帝サルタン
eadwird	Turtles
Blitar Catur	Blitar Catur
hymall	马卓
vyp Hmp Vfe NVim	宋公子
qzj CJvyo GR Kw	不摇碧莲
theindoorkinds	海ヘ行くぞ！
kosenaoki china	古瀬直輝的應援帳號
zhuo ni ataku	⚪あたく♪🟣@水になりたい！！！
gmkuayxl	K UA Y X L V.
yunsulll	茉莉
Uthsp SK	U TH SP SK
Brook Rippling	Brook
yah	弐
xuzhouzhainan	徐州小宅男
Asce	Asce
U Bk Pt FC Xy Vv	到处撒野
V OA Chinese	美国之音中文网
jca PZm Gj RK Xd En	silk美娜 
Pink Devil	Pink Devil
Y PH LV RWonrz	血蝴蝶
phidiasumo	Phidias
Darkdivebombe	ダークダイブ爆撃機
Y Tc UI ZA Nfzo HJ O	無聊大叔
zmr	射手
Qiaozai	Qiao
X II ED BLqyo JS	你幸福吗？我信了你的邪！
t POm Yb Drsy OWf	张蚂蚁重飞
Alllex Hu	小朋友
Wy UC KIm Rw Dyl Wb C	畅快了吗
Oil Diff	新油壶
yeyemiao 	夜夜教主
Bt VW UAh Ho BLn	马仔
jeriessmy	朵朵 Dolly
D CAtomy	D C (台灣寶島農場)
Th EC Rack ER Ba Ro N	𝓜𝓪𝔁. 𝓓𝓲𝓮𝓰𝓸.张麻子
Tot	Tot
zaijian	小王老师
Pw HD Tr Apr Vpo B	饿不死俺屋
shanchahuahua	山茶花花🌸
August	August
wanjunxie	谢万军 Wanjun Xie
T OP TO PS SS TO P	暴力打桩机 互推
y CG TSj Nb JWgmz	想你得夜
rinilaom	王你付款
ypsy Bernard	Bernard小杨
b Jw RUipxg Xvln	创世
G RG R	官人
paulagent	Paul
asdfghjkl	视频分享
Baitaocha	白桃茶
xiaoniaojiangyo	探花社（日没互推拉黑）
nodunjj	姜无邪
guozudong	小郭
a Wenxiansheng	文先生
Zn Pq VB Dur IA X	徐子俊
Boy	Boy
Strelitzia 	K IW IC AT
    Paimon	魈派蒙
dongfangdeyun	视野
pikuotaku	Piku (@pikuotaku) 🌚
P XJ Ru Wss Fh Mg L	小刘同学舔酸奶
Xi Jinping C CN	Xi Jin Ping 习近平
garagedoorguy	真相难觅🇨🇦
I PT Kid	I P’s
Esbp XK LA Fb AJ	真言
Hnlinayi	琳姨太
lingkongmanbu	临空漫步
Charles Lui	鄰居人妻
P YE Pd AR KW FB X	吵吵哈喽
Pedro Abdiel	Petter (xd)
a Wenxiansheng	文先生
g QC XGqu VG Odor	野爹李灬博
Hhbtahe XAqa VS T	Jacky💋 大力💪💪💪
Payne	Paul
allfor Rikimaru 	◡̈ทาสรักริกิ力丸 ~♡
nekopimeow	猫大皮
R NA KY Tops	R NA KY
nice	踢nice
M GM MVto Yy Tjzr	王一博
Melisa Ou O	香菇 Ou O
anshuiki	安
M OS J US TK ID	望月星 ( Taiwanese 🇹🇼 )
Eli Smallnice	廖恩孝
Maibuparat	Mai.B MW ᥫᩣ
xr Oni GQo BI Em Kv	小貴子
Bellayi	Bella
Esbp XK LA Fb AJ	真言
Z Ev GH Jjex KRk Cu	一路向北
Frank hsieh	半澤．彎樹
i Bt RZc EE Ul	急如风火
Daily China News	中文新闻
walkerhsieh	沃
peggyrina	喵
C GU Jb NR RN TQfl Tl	等船
Guittyburnup	れをるの迷弟
Dom Phm	Dom Phạm
wacxl	依酱
franran	I MH OT U
memoryshion	目盛詩園
Eru Xi	醒醒
jxw TKt IL NS Ir	云青
takahit	夏天
Jessie	一土
mianxiangfashi	面相命理法师
Bluesty	已婚雙寶爸
Show	嗯
f GD JYo ME V	重口淫俠
skylar	老鱼
Vince	👻灵
yeyemiao 	夜夜教主
Bluesty	已婚雙寶爸
zifeiyu 	子非鱼🇨🇳🇯🇵
Z Ev GH Jjex KRk Cu	一路向北
wd Xc LT QR Olr V	大笨营
taozijiang 	桃姊
U SA US A	U SA U SA
K Jd QIpry PT SL P	六年級的大叔
hlcjlxc	花气袭人
Jason Y JD	法号净善英文名 Jason
E RY CFfc ZZ Sqwtm	鹿大侠
wangdisheng	王富贵
Pj JU Ko KTuc	姚鹤轩
C Apo	裏垢
hpgq YKa Sqa HJ	苏凯佳
i Qam OX JOb WT W	风儿按摩 SP A师
Zf Sr Edt Blp PCv U	小哥哥
Lu Jf VXskyepmg Dn	璀璨的街景
lm Ffna SIe AY Ua	博采众长
Eleven	張煜雯
adsl	L OS
mikan in june	夏みかん
N TD Chinese	新唐人電視台
mitsune miyagi	宮城 弥恒
Lin Tao V	一只阿斌、
e Tm Cjp Ssjfrk R	冯龙
yuzetao	涛
M UR AS AK IT AN	定無色・戒
g VI Dp EBs Od Wv	不川
Sw WR Mm YYq VMuj E	白枝
sjecxy	🐦小時鳥鳥
r Pin SI Ge EYw Dv	讨教
 Jiayilim 	吴家宜 🍒 jiayi
wai Pui Chan	C WP
pa XG KR Dk GKkf P	起了隆冬强
siaofu	曉芙
luremy 	蓝石
wen   jincong	聪聪
sangersprings	T HO R
iuuuujn	千千
C Rin Ip TPf Vy Pn	推信微特
B KQ HV Efi QG MB PN	杨志宇
beatrice 	Beatrice
sspreadmywingss	這是塔扣
Lau	文誠
xif Qyl Et Bvw	豐原狼 不差
Y Ydexiaogege	倾心明月
Nguoi Bi	Bruh
shuiqiuhan	水秋寒
z Uem CM EBxdw Gf	文言文回复
m Pdw Wn Fare WD	奶牛
asr rg	牛黄
B KQ HV Efi QG MB PN	杨志宇
Oppai DA IS UK I	❤おっぱい大好き❤
collin	Asak
shiziwang	狮子王🦁️
tommy	T S木一
u Bqyl RBd Tog R	幼幼资源q
Newz Pst	No Twit
trevor pup	Pup Trevor🏳️‍🌈
I Sweetmilkshake	奶控👅
briss	Briss
pengyunyan	小渣渣
Song Ci Gen Trad	宋詞生成器
Song Ci Generator	宋词生成器
baiyemijia	百夜米迦尔
Kakaluoter	乔巴*
G GZ ME Kov ZJ	老朱珍言
gundamoba	自衛之道
Ted Daddy	Ted Daddy
Wang Pu	王攵.КРОЛИК
nuannuanmei	妲己
Tav	Tav 
chocosaboten V	チョコサボテン＠μ’ｓと Aqours
B KK Kentarou	Bangkok賤太郎
Peter Pa	Peter Pan
heysunchan	松田青水
Pisces Love	高手來了
y QI WX Ved YQi IK RY	午後奶茶
cwoflk DR NX	夜风吹过
Cqi Sa Yu Fc Zlq T	扛枪小班长
Pablomac	Pablomac
hf Loa EOz Tli Om	糖枫树的枫糖
Tht Th	Thít Đủ Thứ
Tanxinbuzu	貪心不足
pizizhu	痞子主
longlongmima	龙龙
namphuongst	武 黄 江
d AJl MV Vi Nb	陳晨
reiu 	零
Yohann	仔仔
Boythai	Boythai
Dm GVdqn Jw UFakd	木木木木木呀
littleduck	小鴨鴨
minghaiyijiaren	明海一家人
Bu Kg Ncfir HLdo	大大泡泡糖
Salvador Avila C	Salvador Avila Corona
Rinko Arazome	白花幽鬼
Paul Cha	Paul Chan
Rivee P	Bep Hbl
danbaijiang	蛋白酱
Pl JK ZFnp HZ V	梦醒时分
b MR ER LQuutw Zt	大铁棍子医院捅主任
i Hddb Zb Cetk IV	安迪
C Koszs	路易吉
Andy	Andy
goodtony	許若嚴
uoo EBd LK DT Ktl	关山月
Akilli Delos	Akilli Delos
Kelly Joanna	Tam Leung Wang
sky	阿布
K AM AK UR	K AM AK UR A
Moonight to sky	夜月飞雪
n Za Akq Eyv Io	鄰家男孩 彥/欣
e KK GT QMan VCkmd	强
x KG Vy Sq TW MG Evc	前卫
Aday	A day
Y KBl Yz WE Lf Eru	豆芽菜
F F	枫枫🍒
H KLongman	H K 長人
fatmeloveme	刺蝟🦔
H KLongman	H K 長人
tigertail NF SC	老虎尾巴
d KT KE WQw It Kbc UA	南国小生
E TA Lwhaing	惠林パンダちゃん
wb VQ Jd OGu UMgg	龙建飞
g PA Eldypi Verev	跳跳
erbaodjdje	罗森luo
Z YZ GW S	自由中国
lang	蘇炳郎
q TH Hppwgs DG O	想你的（互推）
Tao La Dua	Tao La Dua
H KLongman	H K 長人
an MM GI Wp Wft Rs IS	城城
comhunterxx	下班剿匪
Free Weibo	自由微博
i Hddb Zb Cetk IV	安迪
uglybobangybob	Bob.Yao
zhaoyouweng	哔哩哔哩
O GT SXhe ME KL L	道斎先生
u timmy	Tomy
rd ULtr Aqfjdk	迷 C男神
Ariel Brennan	Ariel Brennan
K Rbz Ub Ai Jp Lz	贵州茅台批发
williamdaharbin	William P. A. da Harbin
mollypooh	維尼汝
Amigo Sunny Cove	Amigo Kapuĉo 阳光湾
Haznilizar	Abe Haznilizar 
diay	夢蝶★
hirokimi	H次郎
zane	Bon
rfda Xwzrsfou A	暖洋洋
wakeupfrog	习近彭
supopo vic	十勝のスポポ🧀
M Yuzikoz	文藝復興ㄐ ‧ Yuzikoz
Tony Zaim	Tony Zaim
Tiffany	Tiffany Ross
 Xiao Long Nu	小龍女
luremy 	蓝石
Miaomi Video	小喵咪（互推）
alisonbiii	Alison
Ming Jing News	明鏡新聞網
Jinjiumaon	津久茂ココア
thotslain	P P Beam
 Xiao Long Nu	小龍女
vqi SVn XRg H	月亮
Owiec	夜
asashi Izumi T W	泉いずみ很喜歡烤櫛瓜
wayne wx	不懒
akshaytens	Akshay
Pcnj	Quack
thaithanh	Thái Thanh
Q Es Fe CY FG Fx A	亂逛路人
Pcnj	Quack
Dvp Nxuy Vjbik QEh	一字脩也
M AK	M AK
F YP	F YP
kekeisboy	性瘾小可乐
Andy	Andy
datie Asaxin	长腿美人阿萨辛
K UI  Y AN G	K UI Y AN G-葵阳先生
Ha CI Gnpz GQp Fpmn	王凯
Carlitoxxx A	Carlitoxxx Alcantar
moonicelin	寒月凌
B OB Sunboy	B OB@Sunboy
rxin	山河
r Dct	沈曼
N TD Chinese	新唐人電視台
peachpiejoon	Pidgeᥫᩣᰃ!
wayne wx	不懒
sehuatang	色花堂
ok	ok山
wayne wx	不懒
oj Aj Tt LFt Qu Bs V	刘思程
understandking	小王子
fengqingyang	申公豹
T QW AN G	Tim🇦🇺
Tin	米粒
Hmjqk Soj IJlu BQ	骆驼
aituno sabu	流山セントラルの森
X XZ WN B	蜜桃
zhangxiaofan	张小凡
X So NN Wxa KIphhan	小可爱
benb	班班
x KG Vy Sq TW MG Evc	前卫
y	y洛
fengqingyang	申公豹
Yourmanfired	观潮起
Sea Sand sdorica	Seasand（浅浮上）
rt LM GF Fg Rz	耿二蛋
oj Aj Tt LFt Qu Bs V	刘思程
z TFp Qv Cbw TS L	撕丝袜好嗨
O DN Malaysia	东方网 Oriental Daily
chichu x	彳亍
sisiya	丝丝
Pcnj	Quack
Titan Huang	Titan Huang
P P Bilzerian	King Bilzerian
Pcnj	Quack
Pl JK ZFnp HZ V	梦醒时分
ffan fu	符帆帆
adkmne	灵儿
volver	那
Tumut	Tum ut
Terry Ch	Terry Chang
miniqiu	mini(互推)
c CM BHve Fa G	孔雀开屏
sisiya	丝丝
pikapika mua	饼子
Hgvj BQ We Xb Uu Si	就溜达了也不违法
ninidainiquwan	妮妮和你一起玩
Lavunia Laspe	糕理治療師
e RY VV Wi ES Ea	瑙茶
Ks Tan	Ks Tan
mugumi timothy	Timothy Megumi
wannadogsex	小枳
Lushanzilong	庐山-紫龙
Prz Von	Prz von vileprz
kexier	可熙
L CC CW	勃弯
Tcnq IN ULxts	小湫
uu Za Rg Nk ZZ Q	林星河
r Ak Bv BX GS WOn	星辰
yuanbeirrr	你的元貝
Si CP Xjr	Simon品序
briandagou	Briandagou
injap YN ZP QY SBj	哦挑剔
paul	Paul
H Z	张
Fitter A	Fitter A
Z EW Z	小鸟依人
Maz Vlp YOo Kjf	抖音风
Z EW Z	小鸟依人
I Mtxw Be Pnfb	死胖子
zhishengji	直升机
Nljns KOz E	爱肉丝袜
baiwei	B V
Qc BIa UW DN Lx Pl Ms	村西透
lixiaoxiao	李筱箫
tm Sn Ot Pk ZS DR	林輝立
hk DW Wy GDd G	城下之盟
shiroijusu	纯白果汁
annamehah	Anna🌿🐑
A S Apple Daily	蘋果日報副刊 果籽
erkin sabit	Erkin S ABİ T
xiaoyingla	小樱啦
qw IOe CA Etge	天博爱游戏总代
damien zhikai	消遣
Aden	Aden
luo mingming	罗罗
xiaoyingla	小樱啦
Yi Zhi San Qiuu	一只三球球
King Taren	高讚 Top☆🌻☀️💧💣🌈
C Timee	千时
individualhsi	阿巴巴啊吧
b BA Dzw Ia EFpqh Au	秋风扫落叶
balibalihon	黑匣子
ttgdlexiaoyao	姚國山
meitree	湧尾樹🌲
Andy	Andy
do China	六度中国
Laura Th	Laura Thompson
beck amayo	Becky Amayo
bad schooler	Girlboss Ange
qzplp Af YP APo	雷轩
Savior Holo Near	C NU NN AK I
M IN GY OY OH	M IN I 翡翠人生
Tacoand C	Tacoand Chip
bottoms	Bottom
pvv ALb Pl MG EE P	李明
cengjingshizhi	我还是这么可爱
o VX SW Mtiwo Ah Z	大地の子🌸🇯🇵🌸
lisa misakanon	好想養貓貓嗚嗚
Two Zhi	兔纸
J OC KE R	奈法利安
edison gao	爱迪生.高♈♠
dashihua	二傻
pingguojiang	平果酱
Oqf GF Ttc Td BMs I	猪野芳春
i CE Ne DL KV IWby SQ	結集
Daily China News	中文新闻
Andy May	Andy May
fn WE PWlt Eeuyk	岁的小骚货
yeissactessa	正念
Allen Hu	Allen HH H
callmeshawn  	尚恩
aopangpang 	转播员
  hoshizora	哭摸
brolanjiao	Brolanjiao
Pai Guat	排骨
Big Catmiao	Big Cat miao🐈
g OL LO NAbvx SJ	行走的骚货
Starfloww	小青楼
Peter Wu	Peter
f RH SPhxt Evlg R	大秦铁骑
The Earth Times	The Earth Times
czxzhuoxuan	陈卓璇₀₈₁₃
P W	P. W.
o Fx Dg Hhs OVjmf	橘莓
It XL Zoggj LNul A	喜欢口味重的
xucong	聪
spicy zasasa	夏莎莎🌶✨✨
monster fuck u	淫亂魔王
O Yi PXub DBs Wo AP	我┬的小执着
pm SJ MHbuhs KH	齐鲁懂王
robberyasd	溫精彩
calvinfu	中山恵希
Andy	Andy
pinkxiaoyun	白云（互推私信）
Andy	Andy
ko Sb XL Sg EUjrq	隔岸观火
Tf Nyu FRpy RF	川建国
tianzongwozhuai	།宫࿈本།
chen tianen	Tianen Chen
ziye usuk	一般通过米英人
xtyzlcz	Paul Liu
iuuuujn	千千
Audrey	V AN
accounker aus TH	🔞Acc Ccer T H🔞
Smzj Q	山姆大叔
tianzongwozhuai	།宫࿈本།
Phi	Phi
Andrs	L MA O
Z JR ON G	卤面
Elian	无意
S OOdwug Tq CSi R	叶青
youuumi	小优米
Htqf RK JP Qb ZT R	兲请嫑昊
ug Fpbn Yf Lvk MI	魔都后情侣
Vhk ZY Gv JVz X	欲静+
jyd Wo SZ Owk Oa P	甜心·丫头
T T	李冰冰
wangganghao	胖子
O WO TA VU Iec S	滅世修羅
B Jo Fyyg Awfue QE	合肥夯先生
w FGka XQsi Ys FW	風情外送茶莊
Ge Lu Lily	綠竹新梢🇨🇦
B Pj SQ El Pp Yw FS	曹三秒
xiaohuliyao	小狐狸妖
daihaomoumou	某某
Hu FL JIu HCsr Ht	你的喵太吖♬
Osaka Lucky	大地の子
En VAxy Flj EU A	性瘾 Y先生
liuyupengddd	白鹭
K Cba TBb Uxtr FJfl	枝枝叶叶
Anna Wruiqin	Anna.wangruiqin
wangzhian	王局志安
wangdavid	猛火龍
Li Xiao Lang 	狼三岁
ndl WYf Ou LGs	♠️紫妍♠️
molly haru	莓莓🌸
chan leo	田三七
Feng Qin Li	Feng Qin Li
sydneydahai	海湾
b zty s	首席
auoaljee	董欣妍
Nd Qv Ktlq HK TE	白狼醬~
zdylovezyxsb	猪宇轩
kageew	Pac
Ton	Ton
Cu QR Vm GX Bkw V	王牌
zero 	壹零
vhbvmoti	Atzin
govievpjst	猪猪
C Kzu Vmrh RAxi	宋茜雯
N GOnews TW	N GO news from Taiwan
jjfjjmlkfj	唧唧复唧唧，木兰开飞机
betaray	放空
ritatabk	红参冻咖啡
jujube	隨風起舞
danieltkn	Daniel Tam
Iam Qun Wu	Qun
Two Cents	My Two Cents
Chen Tommy	Tommy Chen
kirito	習禁評
pgyxvj Nwgfb XCm	小胖子
mobmob	M OB
f Gf Gs Jp QE WYk T	南派派派派啊
y CG TSj Nb JWgmz	想你得夜
T Nf Vg WJ Acg JG Qs	王鹏飞
P LGoih Wx LJ	宗
Chen Min Feng	晨夕
Y Akifuyu	闲人闲语
Tw RS Csi RLay M	君莫
Nuq Gk Qx Ieoh	林志隆
Kinoko Lan	張筱麥
amomo	Amomo
solitary Zzz	世之介
Jingsalover	景飒
beiyudieying	寂寞先生
ale	Ale🌟
Mongoliacruiser	C DB BZ
buzhou	不周
First Sn	麗拔頭籌
crbo AJ NV Ll Kh	大河蜿蜒
ew Lr IJu Cuk Pm	索隆君
tl Fheql Mhf Yx W	長洲🇯🇵景光🏴‍☠
Tasya Noonaa	Tasya🍑
Yaccct lwk	娅娅 ·
k Jw Ay NVi Ymaq S	乐鱼体育
Gtluoli 	狗头萝莉🌈
e KB Gwcke	🐂茂和牛
Amanda R	Amanda Romero
versahorn	Topbot
Gerardo Papiao	Gerardo Blanco
God Like GF	Ghost MT
Z DZv Gx Ey Kywux	活泼的常伯志
Tacoand C	Tacoand Chip
vl Sw FA Cs Cc	內有難步人
scorpionlml	Akui Yurina
edmond roxanne	兰花炖🐟
O IW FK MZhg Wf	莫余sama
wudisanhuang	五帝
Tao Ke Dao	吴钩
Zd IK Sr PF Of WG C	此时彼刻
V NId Qic IYha JO	炫战
kanzhongguo	看中國
ohyaoutdoorstw	鄰家大叔
y Nw Qd Pqft Dhi	王可可
X II ZT	X II ZT
Overthrow CC PNow	Overthrow CC P
edwinzhang	北美新闻
Monsieurmufman	Sg Vers Top
guwen	顾问
a Xvsr Zwuw QYq	浪死啦啊浪
R Rgo Gators	R R@D B沼
Ng Tr Tu	Tom my
C CP V	C CP V
steven ldy	粽子
b BZk PEx NVm JSev	E.P B OO M
xiaowanzi	小丸子
Tinyn	Tin桑
gbvt Ls Ca CYr WC GJ	掌控者《潍坊收奴》
biko 	Biko 
A Luez Hgv Byf Pg V	优质男
Wang Xiaolong	气死你哈哈哈
zkt GIzv LTa Xmi	帅峥
kakult	翔 🎪
black Tsai	black Tsai
Apian	A-pian
legolashahaha	分享爱
fupingpiaobo	小狐狸不熬夜🌙✨⭐️
mmoogg	母⭕🐶
 mmeng	萌萌
A DXz QFygx Ifb	正装s
Ai Ddenlk	南久
Wesson Lee 	李维绅
opqrs	小吱
T OP	T OP
wmhz Ms YJ SSj	君小瀚
N TD Chinese	新唐人電視台
N HW Ioyge NEcgl B	跟随教练
Split Annie	Split Annie
h KL Mq SC Pb B	风追
Two Cents	My Two Cents
Edd BV GX Wi Er	追风少年
Duqfc Xd XOd BO KX	麦克斯
Chi huamin	𝕄𝕚𝕟🤐布喬好唷🐞
f Os PC Dt Hy	程森
eeeeeasy jyanai	我恨期中
tatami	塔塔米
Hovo QNw Up AIm Rts	是騷人也是墨客
Sandymomo	魔法小喇叭🐱
wuliaoyueyuepao	无聊约约炮
chowkinwah	貓婆婆()
V Dll ND UCpg Pz	易高
J Superhero	洛尘
okthkg	性癮學長
Tiaoi T	啼啼ᝰ☘︎
nanyangpress	南洋商报e Nanyang
Blitar Catur	Blitar Catur
pagedown	诺大
lovebtsnkm	橄欖油
Gs Dt DXc Cirv Bf	八旗 R
Iq AZ Vwu Rs	張琤宭
mmzziiaa	熊
Amelia Q OOb	Amelia QO O
yohanbebe 	Y OH AN BE BE
tatami	塔塔米
lishaoxuanli	行不行八点半
D OHrv Jhi Vp RJv	朋友的酒
loshuwentroy	羅澍汶 Troy
yyv PQ Gzd RI MB XX Q	天蠍男的情慾程式
z Rhh ANjevh VGvs	夜痕
small a c	細 A師
Ral Torr	Raúl Torres
flbs Hdrywty X	姜阳
deliaroma	Deli Aroma
Azzael Mzp II	Azzael Mzp
Jnfrv Ch Uxa	喜熊🐻的喵喵
P OT US bot	歴代アメリカ合衆国大統領bot
B KQ HV Efi QG MB PN	杨志宇
Vyeoh W	雄鹰
B P Taiwan FC	Boun Prem T WF C🇹🇼
Gi XO PEjjyg XV	小太陽🌞
Djs HM Rqr MHsy	慧·心
hidyhidyhiding	L AS AM IA
chaichaicaicai	柴柴（可互推）
Salsh Valkyrja 	特級廚師元歌
Andrew LE E	Andrew Lee
nonoismeeeeeee	快乐小桃七
e UFq Mlc Dm Qe UQ	环彩羽
Patrick	Patrick✨
Alexander John D	大基基🍌
mk OG Sx YIk O	欢愉
Ae ZUt CBx PYv BR	🇲🇾新马美女约炮🇸🇬
chunshuitanggg	春水堂
daijiali	欲（互私）
Aung Myo	Aung Myo
Fj DG Ti MGiv Su	左丘无趣
L OV EJ IN	好婆怪
cutebabynan	楠楠酱
wang 	王三一🥸
rubywith	嚕比二世⁷
Adjie	Adjie
mayanganglixiao	北山街
w ZW Od MTbk Nyz	罗朝雷
Sonounpazzo	Signore Piccione
vennhan	幻斂
Asa Kar Yeh	瞪不荔多
f Kn PK Tcsfli VV	高速蜗牛
teresa	王勁
elder JZ M	庆丰包子铺
go AM Vdhu Yi	吴雨
Z Veb Sw GE JWtn	彀外斟唱
Thetruthofthew	士心
Bigmanchris	Bigmanchris
H KLongman	H K 長人
Ftqvx Ui Ge RIeg	Blinblingboy
peggyrina	喵
L ON GM EN WE NY UE	文月
mingrisj	明日世界
Y XD Paul	Paul
Ji Pin Zhi Nan	极品直男
V Nc QM Im Eu Fk	失落的歲月
yo Pus KNvq Rx BYv	长安
wuyong	无用
jujube	隨心所慾
ttokbokijowa	喜歡炒年糕✨
ttokbokijowa	喜歡炒年糕✨
F NNahr JH Zv Mg T	敌敌畏
huanguhu	黄
ikazo	毛毛
laoer	優香
Heather	过客
toushan Bai	白头山🔥
toushan Bai	白头山🔥
Gf Ecle FEg	yy参上
Zhenji	大洋彼岸
rw Dzjl JS Sx A	Dear My Bam
lena km	🌼哩那ᥫ᭡🌼-𝙨𝙡𝙤𝙬
Blackso	Black socks
paraniel	Pa Ra Ni El
   eunn	貝果🥯
ningying	宁盈🐻🐣💙
J XF	纪舷飞
seven orifices	半生熟烏龍茶
deliaroma	Deli Aroma
Taxuewuhen	踏雪无痕
syayofuwan	小肉饭
yttkx	天一
tibettomorrow	Tibettomorrow
Chuen	賤逼精廁
g DV OKxs AS ND Qs	最爱老婆口交
victorxingevan	格子
suibing	碎冰
Kalea	Ava
brucebot	Yong Q IA N
Zhanzhanlover	战战🐰🌰🦐❤️.
Astroil	Astroil
Croro Kie	 💛好耶💚
ce EBm Rg Ea OQm Mo	亂世震驚🇺🇸離開是為了回來
Kumakichi Taro	熊吉太郎
canned pear	梨の缶詰
tujitutu	🐰德川家兔
pz Dxbp IO Cc Rbtie	长安
El Perro YSu Perr	El Perro Y Su Perra
Pi Boom	Pi Boom
stripeboy	斑紋 stripeboy
Rubber Tao	Rubber Tao
chaichaiwanwan	台北野犬
Iq AZ Vwu Rs	張琤宭
leexxchen	李成
Doge Doge	杨咩咩🐑
millouo 	藍紅一定贏
Thetruthofthew	士心
pakekanekohana	Pakekanekohana
real Anthony Lee	老中医w
Wolves Proxy	Wolves Proxy
truong	Truong
twjeff	阿志
Iq AZ Vwu Rs	張琤宭
Jimmy A ZU KI	紅豆 A ZU KI
Wang os	⋆熊·˚ ༘ *
i FB To JGv PI Of F	圆滚滚团子@M M専用
g DV OKxs AS ND Qs	最爱老婆口交
Tim	Tim
d Jacnttfpq Hm B	吳文浩
c CHbp ZI Fh BD G	路西斯
Haku Go Yu	紅果@雜垢
rd Jp OU Vj Xt Hv	陳柳明
lci Tib NO FG GC Cj	九黎
liuzongta	唯爱大奶
S HI VA Y UK IT O	S HI VA 雪兎
Andrew	Andrew
ashengjiang	阿笙
big pineapple	大西瓜🍉🍉🍉
Star Moon GG	💫星月姬☪
yunduqi 	恰肉🍖
R Om EK XBk NO Nv	高磊
Abu Mm	mm Abu
minigirlmizuoto	🌸少女水音(仮)🌸
j SQ ZNe Ik Bb K	文北
q Oy Dpr Zp VNb	知道采购部
Dr Li Meng YA N	Dr. Li-Meng Y AN
Rv WQ Yak US Xblk Q	伴夏温存
k OQ Fu Iuen DO D	傑傑傑若米👅🍌
yinquanliu	刘因全
qi talk	寡人无稽
J Jcaomuzhu	上海野爹
vincent	文邕
Ganda Jlhen	杰西. 🇹🇼🇵🇭
youyoujiang O	又又酱（互推私聊）
H KLongman	H K 長人
mollypooh	維尼汝
D XH HK A	小花花
hct	H CT
malasongf	马拉松
xiaopenghaopang	小彭不开心呜呜呜
vincent	文邕
Y PH LV RWonrz	血蝴蝶
alvey	Alvey
Ah Sen	森哥
f Ibac SAkp UKfq	澈澈
chuangyuer	床欲儿
Hideki Hero	書僮
S EN SA Y	S EN SA Y
ehvvl LL Bu TNj Rw	蜂鸟
U KU Xf ZI Ku Ad	摄像头破解
toushan Bai	白头山🔥
Kim Bun Hong	💕霸王姬👙
Seiron R EA LI TY	錫蘭喔 セイロン
Mindy Fenno	亚博体育 Fenno
Tiger	Tiger
Wei Jiang	姜伟
toushan Bai	白头山🔥
mqkc Ama XUlc Nmxv	ts 龙阳
An	An
Ti Cqcs	楓梟伊
Tony	Tony
Zi KDn LT UJqo Mezk	伪娘潼潼鸭🌟
madetianbing	要開學了
Jack Li	Jack Li文阳
macdillo	有 J物
Babyblue	Babyblue
xlmsnow	Limei 李玫
Kuro Nek	黑先生
S IF Ee Iijpt Ex Pr	林🏎🏁🏁 逆入关
Nn Oi RDv EF Xxoh	子柒
z ubp	张
Maybtm	恐龍
b RPj GG Ybvlzf L	逆夏晴朗
u Lh Qs Mc NV ED US	绿绿波波绿绿
brolanjiao	Brolanjiao
aisisiya	爱斯
Amos J	Amos
realhsiaoping	爱慕安格瑞
Calvin	Bryan
aj UIukin Rd RA	牟谷
yuelangxingxi	月✨
Wu Mei Niang	武媚娘
D Cz UAbw HE Kb L	小九
owl WIw Fild NL	无敌飞
pumkingpump	🌈林姓喵叔🌈
perryhau	然烧
L TX Bryan	Bryan
x Ch Jy JFwv KV Hv	辣椒炒咖啡
Calvin	Bryan
Jack Li	Jack Li文阳
miracleyoung	kitty佳人
d Ky EEl LEr Qrv F	琉璃
tabako 	タバ子
Arthur	Arthur
ljjy	梁軍
mcba RAjti NI	江泽民
sayoharuharu	小夜 春々
Hza Cbu	黄
zhanyilianmeng	战疫联盟
govievpjst	猪猪
chenbrother	陳俊卿
Nljns KOz E	爱肉丝袜
Ben	Ben
Josin	艾尔珀茨🍩
Tony Qi PP	Tony Qi
songshengyj	嵩生岳降
manisa	N-Ppslow
J Thelma Dee	Thelma☮️
tl Sjbip Pzjknv W	奇迹
iphoto tw	點子秀
branloo	叮当
Tommy	Tommy
Sp MP Raczta To	李炫宗
iiam Jazz 	星空
Kusa Ken 	草犬
u Anhfm Tsw VSl	Trump--严小强
kqrp Kw BIv CC YKc R	别说话
beartaotie	小浣熊
Mt GGcfiyau M	明明如月
sportshaoqun	跨境知道
limeasuqumo	曇天🏔
uraj Ea MO Tfbb	烟台公子
siyuefeixu	旁观者
versahorn	Topbot
B B oo ss ss	渣男
qinggeng	晴耕
yunduqi 	恰肉🍖
hefz GCecc	饶敏杰
Peter	Peter
Peter	Peter
homegardenbjslc	小可爱收容所
j SQ ZNe Ik Bb K	文北
Rkf Ge TOg JAm	钮祜禄栋栋
Poi	Poi
Chao	啊 Chao
humeteor	豬世會社
G GH Z	P Way
W ON GK EE NY	Keeny Wong(意无怠)
xueshengyedie S	你学生野爹 S
ylive	高老板
Saobai	骚白弟弟
smallbai	无名美女秅
Allen	Allen
P SV PTrk Uzd Zq	李耀耀
eua Mt RW SB XUaux	守望者
G GH Z	P Way
Daily China News	中文新闻
P RQ KIi Bo Tio Xz A	林聖翔
fuzzzzy 	卯毛
Claire S	伊少女
emol Tmhx Uz ZLvf W	李浩然-支持特朗普总统
Anabel Hudson	Anabel Hudson
Guancha New Media	观察者网新媒体
B LA CK whitepino	ピノ君
y CG TSj Nb JWgmz	想你得夜
Tt Feimaotui	飞猫腿
W EI SH EL VE S	C LO SE A NJ R C LS OE G AG SN AG UP 👟🔙
amanoumi becky	Becky Lytle
itxzrkc	zar开
taropocky	莫魯貝可 ◢
Petch Starish	 E TC 
N Kj LOz Xiaw Ou	春暖花开
Bowang	Bowang
my lostboy	Lost Boy💫
Bt RK BYg JE WQ Qon S	淡忘一切
joomi	啾咪社 App
Amanda B	Amanda Barry
N CTupdating	N CT Updates ↔
botmecu	Botmecu
toushan Bai	白头山🔥
kao	高秉鴻
Metal English	メタラーのための英単語
anchalboy	雑巾の妖精
Kh ZB XVqs Ot AF	一切为何
I GN Hj Gxngic LH	趣多多
aliceindanmei	Alice 🐺🦌
F WVi SCkk Yu HS GTq	肖鸿庆
Nolf Anti CC P	无人永生
Mu Mu 	喵姆🍡
o Dj Lo Ov Kbad Aj O	Y. N. W. A.?
P RQ KIi Bo Tio Xz A	林聖翔
i Fit Star	顾宇辉
Max Of Hellk	M AN NY
Y A N G	低潮期女性
Char Siu Reila	叉焼レイラ🥕💫🐏
Lin Jing bot	林静
K TCsmile 	Pink Cat Bomb💣
haniaprina	H AN I
Jodi Adamson	Jodi Adamson
 Mu Nian Ci	穆念慈
Tommy Goood Guy	Tommy Goodguy
dabudong	大补洞
xumengjie	骑一头笨猪
dzjsqy	紫諾
