XXZWNB	èœœæ¡ƒ
reiu_	é›¶
_iyumeko	å®‰å’Œæ¢¦å­
eELtsFGzMaDti	è¾°
eryu	è€³èª
fRMQSgoOv	ç©†å…†æ´‹
hOEPvBYmutN	ç•™å›­çš„é£
XXZWNB	èœœæ¡ƒ
LUvjnUatbvgc	ç«æŸ´ç›’
Kinky Horny SM	æ˜¥å°å”
BwlXYuBKdiQI	å¤©ç©º
Xiaomeng_mimi	ä¸æœƒèŠå¤©èŒ
XXZWNB	èœœæ¡ƒ
dolloftwit	ãŠãƒã‚«äººå½¢
cxksxf	æ¸©å®‡
VTDQsXemRBNTrG	äºšåšä½“è‚²è¯¾å‘†å‘†
douyinH	æŠ–éŸ³H
_Qiu dong_	çƒåŠ¨
GXBZUYCVBZhG	ç¨‹
xiao shuai	å°å¸…çŒ«
adkmne	çµå„¿
Desmond Hamm	æˆ´åŒ»ç”Ÿ
MhigWakneDZyk	é¾™é˜³å¸å›
tiQNGbNEIHcIx	èƒ¡æ¡ƒå¤¹å­
wangdavid	çŒ›ç«é¾
usAaXAgeJfBxOb	çª—ä¸‹è¥¿ç“œ
Lushan zi long	åºå±±-ç´«é¾™
shui qiuhan	æ°´ç§‹å¯’
chen live	é™ˆå½¬å½¬
XXZWNB	èœœæ¡ƒ
tian tian ovoo	æˆ‘è¶…ç”œçš„
Lushanzilong	åºå±±-ç´«é¾™
hirokimi	Hæ¬¡éƒ
XXZWNB	èœœæ¡ƒ
nagaikei	æ¾ˆ
little angel	å°å¤©ä½¿
wgUEwRHSpzfx	é˜¿æ–¯é¡¿
Ching tian	æ™´å¤©â˜€ï¸
dqamjhnJpTtgz	å°½å‡¡
zZcfQHkhdOFKl	å¤çµç²¾æ€ª
_yikiyomi	èè‰é…±
AtyokR	æ­²å°å¼Ÿå¼Ÿ
SBSRikrrbooQPW	æ‚ä½ï¼æ‚ä½
_yikiyomi	èè‰é…±
linjumming	éºŸå³»éŠ˜
wkzaenRLVLkL	ç‹¬å­¤æ —å­
xiaoxingbrother	ä¸€æ ¹ç¨»è‰
dqamjhnJpTtgz	å°½å‡¡
KHkoBcXCAGg	å²³å²³
wolfgangchuang	å°å—å°æ¬¡éƒ
SCzpIVBpjVqj	éé»‘å³ç™½çš„å…‰è‰²
kmzNqFXPaAH	é¾™å£è¥¿çš„ç‹
himalayajsxj	å°±æ˜¯å…ˆè¿›
DoubleFakeCute	å¤šæˆ²è¶…äºº
huang xiao hao	å‹‡è€…çš„æœ¨æ£’
child like CToao	å€‰å†¬
bali bali hon	é»‘åŒ£å­
likeilei	æ€ æƒ°ãªçŒ«
Love aimer	è›‹é ­
youweigu	äº‘çƒŸå®¢
northn orth	æœ‰åŒ—
Agent Kwok	è»Šå°‰
TiaoiT	å•¼å•¼á°â˜˜ï¸
xuanjiyu	é­šç„æ©Ÿ
jerry	çˆ½çˆ½
VIIJWKKJ	çŸ¢æ¾¤ ã«ã“
XXZWNB	èœœæ¡ƒ
rMCObRRXYxCCL	é‡è§éªšäºº
XXZWNB	èœœæ¡ƒ
Aimer Ssan	èŒé˜¿çŠçŠ
yume_	å®‡å¤¢
tianchaolangren	æ¥¼å‡¤æµªäºº
mFRuvmBoRfTV	æ³¡æ³¡
Huang Fuping	Cçš‡ç”«å¹³a
ywrito	é½å­£
wXaaoACwjjTHHqB	éœ¸é“å°çˆ·ä»¬
ika kichi	é­·å‰/ã‚¤ã‚«å‰
bDVmUubqYvFN	å¼ æ¸…æ¾
ENrfCOCLLHYZ	å·¦äºšå…´å’Œ
VuFYPgHtsrNzNS	å¤§å”é¦®
xChJyJFwvKVHv	è¾£æ¤’ç‚’å’–å•¡
jilRLZkSpgfO	ä¸¾å°ç™½æ——
XofQUmUvzGKTf	å¦‚æœä½ ä¹Ÿæ„›æˆ‘ ğŸ’‹
Radiant HK	æ± æ²¼
wheein be happy	åˆå¤šæ´»äº†ä¸€å¤©
doooiny	æœæ©
chinanewsbot	ä¸­å›½æ–°é—»
fTRGHBheUhvwq	è‹¦å‹äºº
KGPJcrNLxXbEo	ä»™ä»™
JtkoAzJIOujlB	ä¸æ—¶å¸¸çš„æ—¥å¸¸
notesnword_	é¡ğŸ€ä¸‰éº—é·—çš„ç›¤å­
BDlAnwTVFuU	è”¡å¥‡è»’
QhFenSYtLoWwoO	æå†¬
CZhzJsHgSWMWA	ä¸é¢†è¡€
wangseng	ç‹èƒœ
AungMyo	Aung Myo
sumiko aymy	ç‹èŒ‰è‰
kosenaoki china	å¤ç€¬ç›´è¼çš„æ‡‰æ´å¸³è™Ÿ
dangsangwangbo	å®•æ¡‘æ—ºæ³¢
yAQQNkZmYQxn	é€¢å¿å…ˆç”Ÿ
daijiali	æ¬²ï¼ˆäº’ç§ï¼‰
Eppj ffjh	å’šä¸œ
PRWMryVEvJutIH	å¸Œæœ›æ²¡çƒ¦æ¼
bdyDXJQGECgGYl	é›¨è¾°
jVDzzuvfgcFH	é•¿æ²™å°åŒ…å­
shangxiaqixin	ä¸Šä¸‹é½Šå¿ƒ
xuechaigeng	æŸ´æ¢—
shiroijusu	çº¯ç™½æœæ±
igrSYOTJrRGCIb	çˆ±ç¥å·§å…‹åŠ›
DGXjggWsCxJMCf	æ—æ·±ä¸è§é¹¿
JiChouXiaoGuaiS	å·¨æ€ª
mNtcLjujsLXj	åˆ˜è¾‰
jeYekCJLhpPq	é»‘å¤œ
BuyBTSBuy	éŸœå…‰é¤Šæ™¦ğŸ’œ
Taipeisuitbear	å…§è¤²æ§ğŸ…å°åŒ—
gxeZNJrXIUJ	å†œæ°‘å…„å¼Ÿ
yanikibot	ãƒ¤ãƒ‹ã‚­Bot
govievpjst	çŒªçŒª
shikatanori	ç‹ç£Š
govievpjst	çŒªçŒª
Saiki	é½Šæœ¨é›£ç†Š
dIzQtVZHDjx	å²å®‰å®‰å–¬
chair	é¾é¨°äº•
SPKarakuchi	ã‚«ãƒ©ãƒ­å›
JumboAnsom	åŠ‰å­é¾
zhiyuan_monkey	ä¾¯å¿—è½…
xifQylEtBvw	è±åŸç‹¼ ä¸å·®
AakZaOuDvWuP	æˆ‘è¦åƒå¥¶
jJsfXztTNsag	å¤šæ¯›ç‹’ç‹’
rakragrandma	é›â¡ğŸ’›ğŸ’š
Mayflower_cn	äº”æœˆèŠ±
vSnguLwwVYXbF	ç‰§å¥¶ä¼Š
BKQHVEfiQGMBPN	æ¨å¿—å®‡
dfjdxhw	leo å¼Ÿå¼Ÿ
munetakabot	éŸ³é€Ÿã®ã‚½ãƒ‹ãƒƒã‚¯
BKQHVEfiQGMBPN	æ¨å¿—å®‡
qbNNGXLzshLf	å¼µå‡±æ–‡
huruyunfeng	è™å…¥äº‘å³°
BBetter	æ–¯è’‚æ–‡
govievpjst	çŒªçŒª
BfwjLDCkpuo	æ—å­æ˜
mys_tx	è‹—å­çŒ«
fupingpiaobo	å°ç‹ç‹¸ä¸ç†¬å¤œğŸŒ™âœ¨â­ï¸
umblxYfEzVdkLm	æˆ‘æ˜¯è¥¿çº¢æŸ¿ğŸ…
wendy	èŠ™ğŸ
BBetter	æ–¯è’‚æ–‡
GMPingLunY	å…¬æ°‘è¯„è®ºå‘˜âµ
Shino	å°æ³½
aybcHMPqTZq	å•¦å•¦å•¦
fupingpiaobo	å°ç‹ç‹¸ä¸ç†¬å¤œ
fox_nc	é›„æµ‘
linjumming	éºŸå³»éŠ˜
sayoharuharu	å°å¤œ æ˜¥ã€…
bailiusu	ç™½æµè‹
OjATvnpzhJv	ğŸ€èµç¦
AJNperhizdSvwv	æ’çˆ·
GeKiKkfhDA	æˆ‘çš„è„è¢œå­
ZrtAxFNPMpL	å®æ³¢ä¸»æ”¶å¥´
IlpHifxszEYmSu	åŸé‡å°å¹´
k_r_n_o	æˆ‘å°±æ˜¯é€™æ¨£
setlivenews	ä¸‰ç«‹LIVEæ–°è
nnOEyDywkbyCK	æ°´ç«œ
AeDrueetTLOhJ	ç›´ç”·è·å°”è’™
GVsmDwLXe	ä¸€åªç™½ç¾Š
xiaotaojiang	å°æ¡ƒé…±
hpgqYKaSqaHJ	è‹å‡¯ä½³
zhuzhuchuanmen	ç ç ä¸²é—¨
niushiba	ç‰›åå…«
cmyMvCLiRlQdz	å·²å©šäºº
hQaHzEehQb	å³å†°
Hnlinayi	ç³å§¨å¤ª
doudoudewou	å°å…œå…œ
jyNMWNPlYXM	æå®å»º
abcdelittle	å°å°è‘›
xiaomizhou	å°ç±³ç²¥æ— ç³–
Sky_Hurt	é¢œå­èˆª
YdQieHATYFjQU	åŒ»é™¢å¿«é€’
qDryKLvpDwH	ä¹ä¹
YWHENeSBAy	å¢¨è€…
aYpmTQLlorjUgxG	è·è»é›¶è™Ÿ
light_hide	æ¸¡å³¶è‹±ç§‹
yqEqmYCxnPj	å†¬éŸ³
Taxuewuhen	è¸é›ªæ— ç—•
muzhige	æœ¨å­å“¥
FfMDHEJbzSIx	MGæˆ˜å£«
DailyChinaNews	ä¸­æ–‡æ–°é—»
IXFUkpxUJEKWFH	æ±ªå­
xinzhaoyiseng	æ¬¢å–œå¯†æ¢
TrueNdREAM	åœ°ä¸‡ã„‡ã„‡
hgTWfuouKFKdLE	å…³è€çˆ·
Rose__Jack__	è˜¿çµ²å‚‘å…‹
guzhongzhen	å¤§å¤
kVpZKfELRVBRUA	å¤©åœ°è‰¯å¿ƒ
wamei	è¢œå¦¹å¦¹ï½
cPbnbdNLtTFdZ	å°é»‘é»‘
hu_lalalalala	å‡ºåŸƒåŠè®°
yayiaiaiai	ç‰™åŒ»çˆ±çˆ±
iyo_miyon	ä¼Šè±«ä¹ƒã¿ã‚ˆã‚“
lmujian	è€æœ¨
HerBai	å¼ æ—­
timeschina	ä¸­è¯æ™‚å ±
sexsusususu	è‹è‹å­¦å§
lzcnxmh	é•·çˆ·åå¾
LYASM	ADé’™å¥¶
nYHBCjxNIugFT	æ±ªå…ˆç”Ÿ
runawayfromtheh	ç–¯è¶Šé£äººé™¢
grace	æ™“èŠ¸ï¼¨
qHaqEFXhQflRxD	æ—å­ç…Œ
Annastasia_	é˜¿å¨œæ–¯å¡”è¥¿å¨…
oAxqPeQgwwvtF	æ— èŠå¤§å¸ˆ
nvYsUHoYBfoEv	å…‰æ˜æ¬æ·¡
EcQRVTOELnAjB	åˆ˜æˆé¾™
tangguolili	ç³–æœç²’(äº’æ¨)
bilidilimi	å“”å“©æ»´å“©å’ª
GodBlessBPC	Amazing
JqWJgIKnLjH	ä¸‰å­—ä¸´è™š
RuxRNjPz	æ²«æ²³å£
gaojun	å¯‚å†·
wamei	è¢œå¦¹å¦¹ï½
DrWfYUAdoro	æ¨æ€€æ–Œ
huangfandong	é»„ååŠ¨
ucDJfaycLKu	å¤§å®ªç« 
EfGLAmHEmtZoskF	å‰ç¥¥å¦‚æ„
kgajnjan	å°å¢æ˜¯ä¸ªæ©„æ¦„ç»¿
GoSFGeYue	å²³æˆˆ
JZxSfZjgPK	é»„è›‹é»„
liangqinga	å¨å¨˜ã€
heizemeiko	é»‘æ²¢ç¾ç©º
ZhIOUPtiBkzFB	å‚²è¡€å°æ¾å“¥
yztCttqouq	ç½‘è°ƒä¸»
haOlNfLYZcCrE	é”å¡ä½ 
CorningTucke	çœ‹åœ–ç”¨
beimeiduoshou	ç¾å›½å‰æ‰‹
Cave_of_Winto	æ²’æœ‰å–œæ­¡
AnatiAmir	å°ç´
WuJJ	å“ä½ å¥½
zZcfQHkhdOFKl	å¤çµç²¾æ€ª
nKMOuSnBsuenD	é­é¸¿é’§
xiaoniaojiangyo	æ¢èŠ±ç³»åˆ—ï¼ˆæŒç»­æ›´æ–°ï¼‰
shrinkSean	ç‹æ—¶æ•
tanggulashanzei	å”å¤æ‹‰å±±è´¼
hechima_	ğŸ¥’ç“œğŸ¥’
irvinedai	æ·±æ½­
Huiye_furry	è¾‰å¶
CroroKie	 ğŸ’›å¥½è€¶ğŸ’š
natsuki	å¤æ¨¹ãªã¤ãğŸ¯ğŸ¥
lijuxia	çŒ«æœ¬çŒ«
Iogito	Iogito-è€€å“¥
J	éå¾€é›²ç…™
VFNhETnKBtDPym	é…’è¿…
ZEvGHJjexKRkCu	ä¸€è·¯å‘åŒ—
LiYing_	æé¢–
zhuxiuliang	æœ±ä¿®äº®
huruyipekin	èƒ¡å¦‚æ„
Hnlinayi	ç³å§¨å¤ª
Baoshoupai	ç ¸é”…åå…±
xbblxmg	é¸¢å…ˆæ£®
jackylee	è¿‘å†µå¥½å—?
lovebtsnkm	æ©„æ¬–æ²¹
yMBnsVdUdN	èè±†å­
FbmQqbIQFNtjJ	é¾ä¹‹å¿ƒ
icyivymilk	è·›è±¬ğŸ’“
svQAYTGxmstepJc	ç§å¯†
ZWKGZfEfgn	éªšè€
tEgZbnZlTNmIN	åŸå­
wrygyuitlalvunr	ä¸€é’ˆè§è¡€
Bary	Bary
gwLcitNiefPLV	æ˜Ÿæ˜Ÿé»ç‡ˆ
jakdanbeile	å±è™çš„
PitifulServant	Pitiful
xingyinxiaosaoM	å¤¹ä½ å¤§é¸¡é¸¡
luoyanghanzi	ç‰¡ä¸¹èŠ±ä¸‹
wuPMleKaArOKcW	å¼µå…ƒé´»
ghtandyy	Imç½‘ç¥
jPpcqSJrWhaY	å›è§è§
shangxiaqixin	ä¸Šä¸‹é½Šå¿ƒ
NjtQMDMinbovu	LSPæ˜æœˆå“¦
TlnjHMTzuqIrk	ç¬¬ä¸€æ€§
xRpreWoXEQSyyt	æ˜¯å¦å¦å“‡å–
CRinIpTPfVyPn	æ¨ä¿¡å¾®ç‰¹
yeyuan	é£è¡Œ
gaiboyang	æ”¹ä½ å¦¹
ADXzQFygxIfb	æ­£è£…s
ETjFxKIIreORJ	ä¸€äººä¹‹ä¸‹
zhuanyan	è½¬çœ¼
imYULbxmwKXNd	ä¹…ä¿ä¿Šæ˜
dedydedy	çµå”¯
chang	è«é»˜
luoxiaohei_cat	ç½—å°é»‘æ˜¯çŒ«å’ª
kingliu	åˆ˜
nkimo	å£è€çˆº
Jinjiumaon	æ´¥ä¹…èŒ‚ã‚³ã‚³ã‚¢
BOiLlpkhUJbCHN	æ°´é‡Œçš„çŒ«
LpBTgZzxkSOOT	å¤©é“
Cauary	è¦ªè¦ªå¾æ„›
CHXIA	è¿Ÿå¤
fNzelLoRtUFyG	å°ç°ç°
NalaGinrut	å–å†…è£¤çš„å¤§å”
YtVXhsBhVGJ	ç‹æ™ºå‹‡
ZccmQrYuRS	é©¬å…‹
yTNzDICmnsoqXuJ	ç¥ä»™
Chinese_XU	å›å­ä¸­åº¸
caonimazhinazhu	é‡ç¸å…ˆè¼©ç¿’è¿‘å¹³
shosx__	ä¸‰äºŒå…«
nuannuanmei	å¦²å·±
JkEQWqQXTMbKZ	é“ä»”
Ssssxxxjj	æ²ˆç›¸æ°
Cauary	è¦ªè¦ªå¾æ„›
yNHIcZzEsAVbmv	é’å±±ç»¿æ°´
DaoGao	é»‘é»‘
iqsPWuHFGTgxDc	æ™šæ™šæ™š
KizfkmMwvAhXjrj	ä¹¡ä¸‹äºº
Cauary	è¦ªè¦ªå¾æ„›
danielwong	å››çˆ·
Cauary	è¦ªè¦ªå¾æ„›
Iogito	Iogito-è€€å“¥
cccgeorge	ç¶­è¥¿å°¼
jyNMWNPlYXM	æå®å»º
rxin	å±±æ²³
YZKaFownSAqmf	æˆ‘è‡ªå·±
kVktpfWxPe	å‘¨æ³½
xiaoxiaoyu	å°å°é›¨
kungjimbo	è‚–ä¸¸å­
TwtVideoOfChina	æ¨ç‰¹å½±éŸ³ä¸­å›½
fupingpiaobo	å°ç‹ç‹¸ä¸ç†¬å¤œ
NHWIoygeNEcglB	è·Ÿéšæ•™ç»ƒ
twducky_	å˜å˜è‚‰ç¾¹
ZeXbnDLJvgZh	æ—éªæ°
xuge	å¾æ­Œ
helmour_	å¸å¸ğ“ƒ¦
daweijueye	ä¼Ÿçˆµçˆ·
HC_Littleworld	ç©æ²™å¤«å¦»
ecOJApMnNznpP	ä¸œæ–¹æœ¨
yJcCyCNwnVceh	å˜˜å®‰é™
longyang_jun	é¾™é˜³å›
MUYI	æœ¨äº¦
wUYSticmuxleFUM	æµå¹´
huixuanqu	å›æ—‹æ›²
xEymkRismYz	é¢¨ä¸­å¾®å¡µ
hotteokk_	ç³–é¤…
Stormstout	é£æš´çƒˆé…’
ZZWvQoZpvmOGJeP	åƒç»˜
yuelaozaixian	æœˆè€å¦¹å¦¹
lishaoxuanli	è¡Œä¸è¡Œå…«ç‚¹åŠ
hymall	é©¬å“
CHXIA	è¿Ÿå¤
chenkunnan	åŸå§‹äºº
kembaliannongfu	ç¾Šé©¼å´½
uVxFvVzjwngM	å¤§å“¥å¤§å«‚è¿‡å¹´å¥½
okthkg	æ€§ç™®å­¸é•·
lushuwen	é­¯å•¦å•¦
CQYFKMRnhZRyx	è€ä¸‰
realLowpayman	ä½çµ¦æ–™é’å¹´â„¢
fuTRpuMgcxKJe	éŸ¬éŸ¬éŸ¬éŸ¬éŸ¬.
Salllllty_water	é¹¹æ°´ğŸ’¦
usagiai_yani	æ„›é¦™ğŸ’•å‚ç”°å®¶ğŸ‡¨ğŸ‡³
HalloMrSong	åŠæ—¶è¡Œä¹-
heizemeiko	é»‘æ²¢ç¾ç©º
AXbZiRxPfDtaN	å¶è¾°
hapihapisultanz	ãƒãƒ”ãƒãƒ”çš‡å¸ã‚µãƒ«ã‚¿ãƒ³
hymall	é©¬å“
vypHmpVfeNVim	å®‹å…¬å­
qzjCJvyoGRKw	ä¸æ‘‡ç¢§è²
theindoorkinds	æµ·ãƒ˜è¡Œããï¼
kosenaoki_china	å¤ç€¬ç›´è¼çš„æ‡‰æ´å¸³è™Ÿ
yunsulll	èŒ‰è‰
xuzhouzhainan	å¾å·å°å®…ç”·
UBkPtFCXyVv	åˆ°å¤„æ’’é‡
jcaPZmGjRKXdEn	silkç¾å¨œ_
YPHLVRWonrz	è¡€è´è¶
YTcUIZANfzoHJO	ç„¡èŠå¤§å”
zmr	å°„æ‰‹
tPOmYbDrsyOWf	å¼ èš‚èšé‡é£
AlllexHu	å°æœ‹å‹
WyUCKImRwDylWbC	ç•…å¿«äº†å—
OilDiff	æ–°æ²¹å£¶
yeyemiao_	å¤œå¤œæ•™ä¸»
yMBnsVdUdN	èè±†å­
BtVWUAhHoBLn	é©¬ä»”
zaijian	å°ç‹è€å¸ˆ
PwHDTrAprVpoB	é¥¿ä¸æ­»ä¿ºå±‹
shanchahuahua	å±±èŒ¶èŠ±èŠ±ğŸŒ¸
wanjunxie	è°¢ä¸‡å†› Wanjun Xie
yCGTSjNbJWgmz	æƒ³ä½ å¾—å¤œ
rinilaom	ç‹ä½ ä»˜æ¬¾
ypsyBernard	Bernardå°æ¨
bJwRUipxgXvln	åˆ›ä¸–
asdfghjkl	è§†é¢‘åˆ†äº«
Baitaocha	ç™½æ¡ƒèŒ¶
xiaoniaojiangyo	æ¢èŠ±ç¤¾ï¼ˆæ—¥æ²¡äº’æ¨æ‹‰é»‘ï¼‰
nodunjj	å§œæ— é‚ª
guozudong	å°éƒ­
aWenxiansheng	æ–‡å…ˆç”Ÿ
ZnPqVBDurIAX	å¾å­ä¿Š
____Paimon	é­ˆæ´¾è’™
dongfangdeyun	è§†é‡
EsbpXKLAFbAJ	çœŸè¨€
Hnlinayi	ç³å§¨å¤ª
lingkongmanbu	ä¸´ç©ºæ¼«æ­¥
CharlesLui	é„°å±…äººå¦»
PYEPdARKWFBX	åµåµå“ˆå–½
aWenxiansheng	æ–‡å…ˆç”Ÿ
gQCXGquVGOdor	é‡çˆ¹æç¬åš
nekopimeow	çŒ«å¤§çš®
MGMMVtoYyTjzr	ç‹ä¸€åš
MelisaOuO	é¦™è‡OuO
anshuiki	å®‰
EliSmallnice	å»–æ©å­
kSUafJSzCtJzap	é©¬åŠ
Maibuparat	Mai.BMW á¥«á©£
xrOniGQoBIEmKv	å°è²´å­
EsbpXKLAFbAJ	çœŸè¨€
ZEvGHJjexKRkCu	ä¸€è·¯å‘åŒ—
Frank_hsieh	åŠæ¾¤ï¼å½æ¨¹
iBtRZcEEUl	æ€¥å¦‚é£ç«
DailyChinaNews	ä¸­æ–‡æ–°é—»
walkerhsieh	æ²ƒ
peggyrina	å–µ
CGUJbNRRNTQflTl	ç­‰èˆ¹
wacxl	ä¾é…±
franran	IMHOTU
memoryshion	ç›®ç››è©©åœ’
EruXi	é†’é†’
jxwTKtILNSIr	äº‘é’
takahit	å¤å¤©
Jessie	ä¸€åœŸ
mianxiangfashi	é¢ç›¸å‘½ç†æ³•å¸ˆ
Bluesty	å·²å©šé›™å¯¶çˆ¸
Show	å—¯
yMBnsVdUdN	èè±†å­
fGDJYoMEV	é‡å£æ·«ä¿ 
skylar	è€é±¼
Vince	ğŸ‘»çµ
yeyemiao_	å¤œå¤œæ•™ä¸»
Bluesty	å·²å©šé›™å¯¶çˆ¸
zifeiyu_	å­éé±¼
ZEvGHJjexKRkCu	ä¸€è·¯å‘åŒ—
wdXcLTQROlrV	å¤§ç¬¨è¥
taozijiang_	æ¡ƒå§Š
KJdQIpryPTSLP	å…­å¹´ç´šçš„å¤§å”
hlcjlxc	èŠ±æ°”è¢­äºº
ERYCFfcZZSqwtm	é¹¿å¤§ä¾ 
wangdisheng	ç‹å¯Œè´µ
PjJUKoKTuc	å§šé¹¤è½©
CApo	è£å¢
NnumZguwZuhtH	å¾æ›‰ç±³
hpgqYKaSqaHJ	è‹å‡¯ä½³
iQamOXJObWTW	é£å„¿æŒ‰æ‘©SPAå¸ˆ
ZfSrEdtBlpPCvU	å°å“¥å“¥
Eleven	å¼µç…œé›¯
mikan_in_june	å¤ã¿ã‹ã‚“
mitsune_miyagi	å®®åŸ å¼¥æ’
LinTao_V	ä¸€åªé˜¿æ–Œã€
eTmCjpSsjfrkR	å†¯é¾™
VuFYPgHtsrNzNS	å¤§å”é¦®
yuzetao	æ¶›
MURASAKITAN	å®šç„¡è‰²ãƒ»æˆ’
gVIDpEBsOdWv	ä¸å·
SwWRMmYYqVMujE	ç™½æ
agKjYaCEInA	é”çˆ¾æ–‡
sjecxy	ğŸ¦å°æ™‚é³¥é³¥
rPinSIGeEYwDv	è®¨æ•™
siaofu	æ›‰èŠ™
luremy_	è“çŸ³
wen___jincong	èªèª
iuuuujn	åƒåƒ
CRinIpTPfVyPn	æ¨ä¿¡å¾®ç‰¹
BKQHVEfiQGMBPN	æ¨å¿—å®‡
sspreadmywingss	é€™æ˜¯å¡”æ‰£
Lau	æ–‡èª 
xifQylEtBvw	è±åŸç‹¼ ä¸å·®
YYdexiaogege	å€¾å¿ƒæ˜æœˆ
shuiqiuhan	æ°´ç§‹å¯’
zUemCMEBxdwGf	æ–‡è¨€æ–‡å›å¤
mPdwWnFareWD	å¥¶ç‰›
asr_rg	ç‰›é»„
BKQHVEfiQGMBPN	æ¨å¿—å®‡
OppaiDAISUKI	â¤ãŠã£ã±ã„å¤§å¥½ãâ¤
shiziwang	ç‹®å­ç‹ğŸ¦ï¸
tommy	TSæœ¨ä¸€
uBqylRBdTogR	å¹¼å¹¼èµ„æºq
ISweetmilkshake	å¥¶æ§ğŸ‘…
pengyunyan	å°æ¸£æ¸£
SongCiGenTrad	å®‹è©ç”Ÿæˆå™¨
SongCiGenerator	å®‹è¯ç”Ÿæˆå™¨
baiyemijia	ç™¾å¤œç±³è¿¦å°”
Kakaluoter	ä¹”å·´*
gundamoba	è‡ªè¡›ä¹‹é“
nuannuanmei	å¦²å·±
chocosabotenV	ãƒãƒ§ã‚³ã‚µãƒœãƒ†ãƒ³ï¼ Î¼â€™ï½“ã¨Aqours
heysunchan	æ¾ç”°é’æ°´
Pisces_Love	é«˜æ‰‹ä¾†äº†
YNckuUAbLbbYGW	æ ¸æ¡ƒâ™¥
yQIWXVedYQiIKRY	åˆå¾Œå¥¶èŒ¶
cwoflkDRNX	å¤œé£å¹è¿‡
lPeeMSPxtYLKefa	ä¸€å¶
hfLoaEOzTliOm	ç³–æ«æ ‘çš„æ«ç³–
lrv_ow	FREUPL
Tanxinbuzu	è²ªå¿ƒä¸è¶³
pizizhu	ç—å­ä¸»
longlongmima	é¾™é¾™
namphuongst	æ­¦ é»„ æ±Ÿ
dAJlMVViNb	é™³æ™¨
reiu_	é›¶
Yohann	ä»”ä»”
ioMlIHFQLIPQRn	åŠ èŒ‚
DmGVdqnJwUFakd	æœ¨æœ¨æœ¨æœ¨æœ¨å‘€
littleduck	å°é´¨é´¨
minghaiyijiaren	æ˜æµ·ä¸€å®¶äºº
BuKgNcfirHLdo	å¤§å¤§æ³¡æ³¡ç³–
RinkoArazome	ç™½èŠ±å¹½é¬¼
danbaijiang	è›‹ç™½é…±
PlJKZFnpHZV	æ¢¦é†’æ—¶åˆ†
iHddbZbCetkIV	å®‰è¿ª
goodtony	è¨±è‹¥åš´
uooEBdLKDTKtl	å…³å±±æœˆ
sky	é˜¿å¸ƒ
Moonight_to_sky	å¤œæœˆé£é›ª
eKKGTQManVCkmd	å¼º
xKGVySqTWMGEvc	å‰å«
YKBlYzWELfEru	è±†èŠ½èœ
HKLongman	HK é•·äºº
HKLongman	HK é•·äºº
fuJRSvAlisn	é¾åäºŒ
tigertailNFSC	è€è™å°¾å·´
dKTKEWQwItKbcUA	å—å›½å°ç”Ÿ
wbVQJdOGuUMgg	é¾™å»ºé£
gPAEldypiVerev	è·³è·³
SWsshplFKUmUd	ä¸€æ›²
lang	è˜‡ç‚³éƒ
HKLongman	HK é•·äºº
anMMGIWpWftRsIS	åŸåŸ
kCQeJVUkdHsRn	é˜¿è¥¿å§
comhunterxx	ä¸‹ç­å‰¿åŒª
FreeWeibo	è‡ªç”±å¾®åš
iHddbZbCetkIV	å®‰è¿ª
zhaoyouweng	å“”å“©å“”å“©
OGTSXheMEKLL	é“æ–å…ˆç”Ÿ
u_timmy	Tomy
rdULtrAqfjdk	è¿·Cç”·ç¥
KRbzUbAiJpLz	è´µå·èŒ…å°æ‰¹å‘
mollypooh	ç¶­å°¼æ±
diay	å¤¢è¶â˜…
hirokimi	Hæ¬¡éƒ
rfdaXwzrsfouA	æš–æ´‹æ´‹
wakeupfrog	ä¹ è¿‘å½­
xTZgUtxjnRGD	å´å¿ƒå®‡
supopo_vic	åå‹ã®ã‚¹ãƒãƒğŸ§€
_XiaoLongNu	å°é¾å¥³
luremy_	è“çŸ³
MiaomiVideo	å°å–µå’ªï¼ˆäº’æ¨ï¼‰
MingJingNews	æ˜é¡æ–°èç¶²
Jinjiumaon	æ´¥ä¹…èŒ‚ã‚³ã‚³ã‚¢
_XiaoLongNu	å°é¾å¥³
vqiSVnXRgH	æœˆäº®
Owiec	å¤œ
wayne_wx	ä¸æ‡’
QEsFeCYFGFxA	äº‚é€›è·¯äºº
DvpNxuyVjbikQEh	ä¸€å­—è„©ä¹Ÿ
kekeisboy	æ€§ç˜¾å°å¯ä¹
HaCIGnpzGQpFpmn	ç‹å‡¯
moonicelin	å¯’æœˆå‡Œ
rxin	å±±æ²³
wayne_wx	ä¸æ‡’
sehuatang	è‰²èŠ±å ‚
wayne_wx	ä¸æ‡’
ojAjTtLFtQuBsV	åˆ˜æ€ç¨‹
understandking	å°ç‹å­
fengqingyang	ç”³å…¬è±¹
Tin	ç±³ç²’
HmjqkSojIJluBQ	éª†é©¼
aituno_sabu	æµå±±ã‚»ãƒ³ãƒˆãƒ©ãƒ«ã®æ£®
XXZWNB	èœœæ¡ƒ
zhangxiaofan	å¼ å°å‡¡
XSoNNWxaKIphhan	å°å¯çˆ±
xKGVySqTWMGEvc	å‰å«
fengqingyang	ç”³å…¬è±¹
Yourmanfired	è§‚æ½®èµ·
rtLMGFFgRz	è€¿äºŒè›‹
ojAjTtLFtQuBsV	åˆ˜æ€ç¨‹
zTFpQvCbwTSL	æ’•ä¸è¢œå¥½å—¨
KBTK	çŒ«
chichu_x	å½³äº
sisiya	ä¸ä¸
PlJKZFnpHZV	æ¢¦é†’æ—¶åˆ†
ffan_fu	ç¬¦å¸†å¸†
adkmne	çµå„¿
volver	é‚£
miniqiu	mini(äº’æ¨)
sisiya	ä¸ä¸
pikapika_mua	é¥¼å­
ninidainiquwan	å¦®å¦®å’Œä½ ä¸€èµ·ç©
Lavunia_Laspe	ç³•ç†æ²»ç™‚å¸«
eRYVVWiESEa	ç‘™èŒ¶
wannadogsex	å°æ³
hRXPcOaUrOF	å¯’å‡Œ
Lushanzilong	åºå±±-ç´«é¾™
kexier	å¯ç†™
TcnqINULxts	å°æ¹«
uuZaRgNkZZQ	æ—æ˜Ÿæ²³
rAkBvBXGSWOn	æ˜Ÿè¾°
yuanbeirrr	ä½ çš„å…ƒè²
SiCPXjr	Simonå“åº
injapYNZPQYSBj	å“¦æŒ‘å‰”
MazVlpYOoKjf	æŠ–éŸ³é£
IMtxwBePnfb	æ­»èƒ–å­
zhishengji	ç›´å‡æœº
NljnsKOzE	çˆ±è‚‰ä¸è¢œ
QcBIaUWDNLxPlMs	æ‘è¥¿é€
lixiaoxiao	æç­±ç®«
tmSnOtPkZSDR	æ—è¼ç«‹
shiroijusu	çº¯ç™½æœæ±
BsCXCccrBsOUD	æ¬²å…½
xiaoyingla	å°æ¨±å•¦
damien_zhikai	æ¶ˆé£
luo_mingming	ç½—ç½—
xiaoyingla	å°æ¨±å•¦
individualhsi	é˜¿å·´å·´å•Šå§
bBADzwIaEFpqhAu	ç§‹é£æ‰«è½å¶
balibalihon	é»‘åŒ£å­
ttgdlexiaoyao	å§šåœ‹å±±
meitree	æ¹§å°¾æ¨¹ğŸŒ²
doChina	å…­åº¦ä¸­å›½
qzplpAfYPAPo	é›·è½©
SaviorHoloNear	CNUNNAKI
pvvALbPlMGEEP	ææ˜
cengjingshizhi	æˆ‘è¿˜æ˜¯è¿™ä¹ˆå¯çˆ±
oVXSWMtiwoAhZ	å¤§åœ°ã®å­ğŸŒ¸ğŸ‡¯ğŸ‡µğŸŒ¸
lisa_misakanon	å¥½æƒ³é¤Šè²“è²“å—šå—š
JOCKER	å¥ˆæ³•åˆ©å®‰
edison_gao	çˆ±è¿ªç”Ÿ.é«˜â™ˆâ™ 
dashihua	äºŒå‚»
pingguojiang	å¹³æœé…±
OqfGFTtcTdBMsI	çŒªé‡èŠ³æ˜¥
DailyChinaNews	ä¸­æ–‡æ–°é—»
yeissactessa	æ­£å¿µ
callmeshawn__	å°šæ©
aopangpang_	è½¬æ’­å‘˜
__hoshizora	å“­æ‘¸
PaiGuat	æ’éª¨
gOLLONAbvxSJ	è¡Œèµ°çš„éªšè´§
Starfloww	å°é’æ¥¼
PeterWu	Peter
fRHSPhxtEvlgR	å¤§ç§¦é“éª‘
oFxDgHhsOVjmf	æ©˜è“
xucong	èª
spicy_zasasa	å¤èèğŸŒ¶âœ¨âœ¨
monster_fuck_u	æ·«äº‚é­”ç‹
OYiPXubDBsWoAP	æˆ‘â”¬çš„å°æ‰§ç€
pmSJMHbuhsKH	é½é²æ‡‚ç‹
CCPvirus_	æ¾³å–œ
robberyasd	æº«ç²¾å½©
calvinfu	ä¸­å±±æµå¸Œ
pinkxiaoyun	ç™½äº‘ï¼ˆäº’æ¨ç§ä¿¡ï¼‰
koSbXLSgEUjrq	éš”å²¸è§‚ç«
tianzongwozhuai	à¼å®«à¿ˆæœ¬à¼
vsHXWwCteS	æä¼Ÿ
ziye_usuk	ä¸€èˆ¬é€šè¿‡ç±³è‹±äºº
iuuuujn	åƒåƒ
SmzjQ	å±±å§†å¤§å”
tianzongwozhuai	à¼å®«à¿ˆæœ¬à¼
Elian	æ— æ„
SOOdwugTqCSiR	å¶é’
youuumi	å°ä¼˜ç±³
HtqfRKJPQbZTR	å…²è¯·å«‘æ˜Š
ugFpbnYfLvkMI	é­”éƒ½åæƒ…ä¾£
VhkZYGvJVzX	æ¬²é™+
jydWoSZOwkOaP	ç”œå¿ƒÂ·ä¸«å¤´
wangganghao	èƒ–å­
OWOTAVUIecS	æ»…ä¸–ä¿®ç¾…
BJoFyygAwfueQE	åˆè‚¥å¤¯å…ˆç”Ÿ
wFGkaXQsiYsFW	é¢¨æƒ…å¤–é€èŒ¶èŠ
BPjSQElPpYwFS	æ›¹ä¸‰ç§’
xiaohuliyao	å°ç‹ç‹¸å¦–
daihaomoumou	æŸæŸ
sdBJXDmJDoyS	åº·åº·
HuFLJIuHCsrHt	ä½ çš„å–µå¤ªå–â™¬
EnVAxyFljEUA	æ€§ç˜¾Yå…ˆç”Ÿ
liuyupengddd	ç™½é¹­
TLWRFoRoClkGlC	æè‹¹
KCbaTBbUxtrFJfl	ææå¶å¶
wangzhian	ç‹å±€å¿—å®‰
wangdavid	çŒ›ç«é¾
LiXiaoLang_	ç‹¼ä¸‰å²
ndlWYfOuLGs	â™ ï¸ç´«å¦â™ ï¸
molly_haru	è“è“ğŸŒ¸
chan_leo	ç”°ä¸‰ä¸ƒ
kHSybeOlArIOQ	ç´«æ¢¦
sydneydahai	æµ·æ¹¾
b_zty_s	é¦–å¸­
auoaljee	è‘£æ¬£å¦
NdQvKtlqHKTE	ç™½ç‹¼é†¬~
zdylovezyxsb	çŒªå®‡è½©
CuQRVmGXBkwV	ç‹ç‰Œ
zero_	å£¹é›¶
govievpjst	çŒªçŒª
CKzuVmrhRAxi	å®‹èŒœé›¯
jjfjjmlkfj	å”§å”§å¤å”§å”§ï¼Œæœ¨å…°å¼€é£æœº
betaray	æ”¾ç©º
ritatabk	çº¢å‚å†»å’–å•¡
jujube	éš¨é¢¨èµ·èˆ
kirito	ç¿’ç¦è©•
pgyxvjNwgfbXCm	å°èƒ–å­
fGfGsJpQEWYkT	å—æ´¾æ´¾æ´¾æ´¾å•Š
yCGTSjNbJWgmz	æƒ³ä½ å¾—å¤œ
TNfVgWJAcgJGQs	ç‹é¹é£
PLGoihWxLJ	å®—
ChenMinFeng	æ™¨å¤•
YAkifuyu	é—²äººé—²è¯­
TwRSCsiRLayM	å›è«
NuqGkQxIeoh	æ—å¿—éš†
KinokoLan	å¼µç­±éº¥
SfjAekFxOidYpW	é“¶é’¥
solitary_Zzz	ä¸–ä¹‹ä»‹
Jingsalover	æ™¯é£’
beiyudieying	å¯‚å¯å…ˆç”Ÿ
QHQxoEtSLCLPsQ	å¤å‘èŠ¸
buzhou	ä¸å‘¨
FirstSn	éº—æ‹”é ­ç±Œ
crboAJNVLlKh	å¤§æ²³èœ¿èœ’
your_LIeGHT	é–ƒå…‰
ewLrIJuCukPm	ç´¢éš†å›
TasyaNoonaa	TasyağŸ‘
Yaccct_lwk	å¨…å¨…
kJwAyNViYmaqS	ä¹é±¼ä½“è‚²
Gtluoli_	ç‹—å¤´èè‰ğŸŒˆ
vlSwFACsCc	å…§æœ‰é›£æ­¥äºº
XTeJbbLEDSq	é¡å¼˜æ†
edmond_roxanne	å…°èŠ±ç‚–ğŸŸ
wudisanhuang	äº”å¸
TaoKeDao	å´é’©
ZdIKSrPFOfWGC	æ­¤æ—¶å½¼åˆ»
VNIdQicIYhaJO	ç‚«æˆ˜
kanzhongguo	çœ‹ä¸­åœ‹
ohyaoutdoorstw	é„°å®¶å¤§å”
yNwQdPqftDhi	ç‹å¯å¯
XIIZT	XIIZT
BBZMVnxLtQONEG	è®°å¿†
edwinzhang	åŒ—ç¾æ–°é—»
guwen	é¡¾é—®
aXvsrZwuwQYq	æµªæ­»å•¦å•Šæµª
steven_ldy	ç²½å­
xiaowanzi	å°ä¸¸å­
Tinyn	Tinæ¡‘
songyu_SY	å€¥å„¿
ALuezHgvByfPgV	ä¼˜è´¨ç”·
WangXiaolong	æ°”æ­»ä½ å“ˆå“ˆå“ˆ
zktGIzvLTaXmi	å¸…å³¥
kakult	ç¿” ğŸª
legolashahaha	åˆ†äº«çˆ±
fupingpiaobo	å°ç‹ç‹¸ä¸ç†¬å¤œğŸŒ™âœ¨â­ï¸
mmoogg	æ¯â­•ğŸ¶
_mmeng	èŒèŒ
ADXzQFygxIfb	æ­£è£…s
AiDdenlk	å—ä¹…
Wesson_Lee_	æç»´ç»…
ugzKNCaLdKZ	é¹…æ»´ç¥
opqrs	å°å±
wmhzMsYJSSj	å›å°ç€š
NHWIoygeNEcglB	è·Ÿéšæ•™ç»ƒ
hKLMqSCPbB	é£è¿½
EddBVGXWiEr	è¿½é£å°‘å¹´
DuqfcXdXOdBOKX	éº¦å…‹æ–¯
Chi_huamin	ğ•„ğ•šğ•ŸğŸ¤å¸ƒå–¬å¥½å”·ğŸ
fOsPCDtHy	ç¨‹æ£®
eeeeeasy_jyanai	æˆ‘æ¨æœŸä¸­
tatami	å¡”å¡”ç±³
HovoQNwUpAImRts	æ˜¯é¨·äººä¹Ÿæ˜¯å¢¨å®¢
Sandymomo	é­”æ³•å°å–‡å­ğŸ±
wuliaoyueyuepao	æ— èŠçº¦çº¦ç‚®
chowkinwah	è²“å©†å©†()
VDllNDUCpgPz	æ˜“é«˜
JSuperhero	æ´›å°˜
okthkg	æ€§ç™®å­¸é•·
TiaoiT	å•¼å•¼á°â˜˜ï¸
nanyangpress	å—æ´‹å•†æŠ¥
pagedown	è¯ºå¤§
lovebtsnkm	æ©„æ¬–æ²¹
GsDtDXcCirvBf	å…«æ——R
IqAZVwuRs	å¼µç¤å®­
mmzziiaa	ç†Š
tatami	å¡”å¡”ç±³
lishaoxuanli	è¡Œä¸è¡Œå…«ç‚¹åŠ
DOHrvJhiVpRJv	æœ‹å‹çš„é…’
zRhhANjevhVGvs	å¤œç—•
flbsHdrywtyX	å§œé˜³
aYpmTQLlorjUgxG	è·è»é›¶è™Ÿ
BKQHVEfiQGMBPN	æ¨å¿—å®‡
VyeohW	é›„é¹°
GiXOPEjjygXV	å°å¤ªé™½ğŸŒ
DjsHMRqrMHsy	æ…§Â·å¿ƒ
APwcLpihPDOQGLI	å¼¹è·
chaichaicaicai	æŸ´æŸ´ï¼ˆå¯äº’æ¨ï¼‰
Salsh_Valkyrja_	ç‰¹ç´šå»šå¸«å…ƒæ­Œ
nonoismeeeeeee	å¿«ä¹å°æ¡ƒä¸ƒ
eUFqMlcDmQeUQ	ç¯å½©ç¾½
AlexanderJohnD	å¤§åŸºåŸºğŸŒ
mkOGSxYIkO	æ¬¢æ„‰
AeZUtCBxPYvBR	ğŸ‡²ğŸ‡¾æ–°é©¬ç¾å¥³çº¦ç‚®ğŸ‡¸ğŸ‡¬
chunshuitanggg	æ˜¥æ°´å ‚
daijiali	æ¬²ï¼ˆäº’ç§ï¼‰
FjDGTiMGivSu	å·¦ä¸˜æ— è¶£
LOVEJIN	å¥½å©†æ€ª
cutebabynan	æ¥ æ¥ é…±
wang_	ç‹ä¸‰ä¸€ğŸ¥¸
rubywith	åš•æ¯”äºŒä¸–â·
mayanganglixiao	åŒ—å±±è¡—
wZWOdMTbkNyz	ç½—æœé›·
vennhan	å¹»æ–‚
AsaKarYeh	çªä¸è”å¤š
fKnPKTcsfliVV	é«˜é€Ÿèœ—ç‰›
teresa	ç‹å‹
goAMVdhuYi	å´é›¨
ZVebSwGEJWtn	å½€å¤–æ–Ÿå”±
Thetruthofthew	å£«å¿ƒ
HKLongman	HK é•·äºº
peggyrina	å–µ
LONGMENWENYUE	æ–‡æœˆ
mingrisj	æ˜æ—¥ä¸–ç•Œ
JiPinZhiNan	æå“ç›´ç”·
VNcQMImEuFk	å¤±è½çš„æ­²æœˆ
yoPusKNvqRxBYv	é•¿å®‰
wuyong	æ— ç”¨
jujube	éš¨å¿ƒæ‰€æ…¾
ttokbokijowa	å–œæ­¡ç‚’å¹´ç³•âœ¨
mIBmoSohHya	æè¿›
ttokbokijowa	å–œæ­¡ç‚’å¹´ç³•âœ¨
AOI_SUZUKI_	éˆ´æœ¨ã‚Šã‚‰ğŸŸ
FNNahrJHZvMgT	æ•Œæ•Œç•
huanguhu	é»„
ikazo	æ¯›æ¯›
laoer	å„ªé¦™
Heather	è¿‡å®¢
toushan_Bai	ç™½å¤´å±±ğŸ”¥
toushan_Bai	ç™½å¤´å±±ğŸ”¥
GfEcleFEg	yyå‚ä¸Š
Zhenji	å¤§æ´‹å½¼å²¸
lena_km	ğŸŒ¼å“©é‚£á¥«á­¡ğŸŒ¼-ğ™¨ğ™¡ğ™¤ğ™¬
___eunn	è²æœğŸ¥¯
WbErVSDacZRYl	å…‰è¼æ­²æœˆ
ningying	å®ç›ˆğŸ»ğŸ£ğŸ’™
JXF	çºªèˆ·é£
seven_orifices	åŠç”Ÿç†Ÿçƒé¾èŒ¶
Taxuewuhen	è¸é›ªæ— ç—•
syayofuwan	å°è‚‰é¥­
yttkx	å¤©ä¸€
Chuen	è³¤é€¼ç²¾å»
nMJPyNmgtcHSHHG	é£å
victorxingevan	æ ¼å­
suibing	ç¢å†°
Zhanzhanlover	æˆ˜æˆ˜ğŸ°ğŸŒ°ğŸ¦â¤ï¸.
Astroil	Astroil
CroroKie	 ğŸ’›å¥½è€¶ğŸ’š
Kumakichi_Taro	ç†Šå‰å¤ªéƒ
canned_pear	æ¢¨ã®ç¼¶è©°
tujitutu	ğŸ°å¾·å·å®¶å…”
pzDxbpIOCcRbtie	é•¿å®‰
stripeboy	æ–‘ç´‹ stripeboy
chaichaiwanwan	å°åŒ—é‡çŠ¬
IqAZVwuRs	å¼µç¤å®­
leexxchen	ææˆ
DogeDoge	æ¨å’©å’©ğŸ‘
millouo_	è—ç´…ä¸€å®šè´
Thetruthofthew	å£«å¿ƒ
realAnthonyLee	è€ä¸­åŒ»w
twjeff	é˜¿å¿—
IqAZVwuRs	å¼µç¤å®­
Jimmy_AZUKI	ç´…è±†_AZUKI
dJacnttfpqHmB	å³æ–‡æµ©
cCHbpZIFhBDG	è·¯è¥¿æ–¯
Haku_GoYu	ç´…æœ@é›œå¢
rdJpOUVjXtHv	é™³æŸ³æ˜
lciTibNOFGGCCj	ä¹é»
liuzongta	å”¯çˆ±å¤§å¥¶
SHIVA_YUKITO	SHIVA é›ªå…
Andrew	Andrew
ashengjiang	é˜¿ç¬™
oehecPTsbXMe	è€å…«
big_pineapple	å¤§è¥¿ç“œğŸ‰ğŸ‰ğŸ‰
StarMoonGG	ğŸ’«æ˜Ÿæœˆå§¬â˜ª
yunduqi_	æ°è‚‰ğŸ–
ROmEKXBkNONv	é«˜ç£Š
GIUdHDvudLTP	å°é‡
minigirlmizuoto	ğŸŒ¸å°‘å¥³æ°´éŸ³(ä»®)ğŸŒ¸
jSQZNeIkBbK	æ–‡åŒ—
GWVSLnqYDrnD	é§¿æµ©
RvWQYakUSXblkQ	ä¼´å¤æ¸©å­˜
kOQFuIuenDOD	å‚‘å‚‘å‚‘è‹¥ç±³ğŸ‘…ğŸŒ
yinquanliu	åˆ˜å› å…¨
qi_talk	å¯¡äººæ— ç¨½
JJcaomuzhu	ä¸Šæµ·é‡çˆ¹
vincent	æ–‡é‚•
GandaJlhen	æ°è¥¿. ğŸ‡¹ğŸ‡¼ğŸ‡µğŸ‡­
youyoujiangO	åˆåˆé…±ï¼ˆäº’æ¨ç§èŠï¼‰
HKLongman	HK é•·äºº
mollypooh	ç¶­å°¼æ±
malasongf	é©¬æ‹‰æ¾
blackAppearor	é»‘ä»ª
xiaopenghaopang	å°å½­ä¸å¼€å¿ƒå‘œå‘œå‘œ
vincent	æ–‡é‚•
YPHLVRWonrz	è¡€è´è¶
alvey	Alvey
DHBRRSeDzWsVCSr	æ—æ•¬æ’
AhSen	æ£®å“¥
fIbacSAkpUKfq	æ¾ˆæ¾ˆ
chuangyuer	åºŠæ¬²å„¿
Hideki_Hero	æ›¸åƒ®
ehvvlLLBuTNjRw	èœ‚é¸Ÿ
toushan_Bai	ç™½å¤´å±±ğŸ”¥
rHaDZdJopyfusy	å¤§æ ¹
KimBunHong	ğŸ’•éœ¸ç‹å§¬ğŸ‘™
Seiron_REALITY	éŒ«è˜­å–” ã‚»ã‚¤ãƒ­ãƒ³
MindyFenno	äºšåšä½“è‚²Fenno
Wei_Jiang	å§œä¼Ÿ
jqrEIlehqsoWmK	éœ¸å‘Š
EStHrHkWoiKbSmx	æ‹¿å¡é‡Œ
toushan_Bai	ç™½å¤´å±±ğŸ”¥
TiCqcs	æ¥“æ¢Ÿä¼Š
ZiKDnLTUJqoMezk	ä¼ªå¨˜æ½¼æ½¼é¸­ğŸŒŸ
madetianbing	è¦é–‹å­¸äº†
macdillo	æœ‰Jç‰©
xlmsnow	Limei æç«
SIFEeIijptExPr	æ—ğŸğŸğŸ é€†å…¥å…³
NnOiRDvEFXxoh	å­æŸ’
z_ubp	å¼ 
Maybtm	æé¾
bRPjGGYbvlzfL	é€†å¤æ™´æœ—
uLhQsMcNVEDUS	ç»¿ç»¿æ³¢æ³¢ç»¿ç»¿
aisisiya	çˆ±æ–¯
realhsiaoping	çˆ±æ…•å®‰æ ¼ç‘
PrRoZTCwA	è°·é£
ajUIukinRdRA	ç‰Ÿè°·
yuelangxingxi	æœˆâœ¨
WuMeiNiang	æ­¦åªšå¨˜
DCzUAbwHEKbL	å°ä¹
owlWIwFildNL	æ— æ•Œé£
pumkingpump	ğŸŒˆæ—å§“å–µå”ğŸŒˆ
perryhau	ç„¶çƒ§
xChJyJFwvKVHv	è¾£æ¤’ç‚’å’–å•¡
miracleyoung	kittyä½³äºº
dKyEElLErQrvF	ç‰ç’ƒ
ljjy	æ¢è»
mcbaRAjtiNI	æ±Ÿæ³½æ°‘
eUNwAjXsgKWUeR	èŒèŠ
sayoharuharu	å°å¤œ æ˜¥ã€…
HzaCbu	é»„
zhanyilianmeng	æˆ˜ç–«è”ç›Ÿ
govievpjst	çŒªçŒª
chenbrother	é™³ä¿Šå¿
NljnsKOzE	çˆ±è‚‰ä¸è¢œ
Josin	è‰¾å°”ç€èŒ¨ğŸ©
songshengyj	åµ©ç”Ÿå²³é™
meAVXZoaZEzpv	å®‰å¢¨
tlSjbipPzjknvW	å¥‡è¿¹
iphoto_tw	é»å­ç§€
branloo	å®å½“
SpMPRacztaTo	æç‚«å®—
iiamJazz_	æ˜Ÿç©º
Kusa_Ken_	è‰çŠ¬
kqrpKwBIvCCYKcR	åˆ«è¯´è¯
beartaotie	å°æµ£ç†Š
MtGGcfiyauM	æ˜æ˜å¦‚æœˆ
sportshaoqun	è·¨å¢ƒçŸ¥é“
limeasuqumo	æ›‡å¤©ğŸ”
urajEaMOTfbb	çƒŸå°å…¬å­
siyuefeixu	æ—è§‚è€…
BB_oo_ss_ss	æ¸£ç”·
qinggeng	æ™´è€•
yunduqi_	æ°è‚‰ğŸ–
homegardenbjslc	å°å¯çˆ±æ”¶å®¹æ‰€
jSQZNeIkBbK	æ–‡åŒ—
RkfGeTOgJAm	é’®ç¥œç¦„æ ‹æ ‹
MMfgLERdLRW	æ—
humeteor	è±¬ä¸–æœƒç¤¾
xueshengyedieS	ä½ å­¦ç”Ÿé‡çˆ¹S
ylive	é«˜è€æ¿
Saobai	éªšç™½å¼Ÿå¼Ÿ
smallbai	æ— åç¾å¥³ç§…
PSVPTrkUzdZq	æè€€è€€
euaMtRWSBXUaux	å®ˆæœ›è€…
DailyChinaNews	ä¸­æ–‡æ–°é—»
PRQKIiBoTioXzA	æ—è–ç¿”
fuzzzzy_	å¯æ¯›
ClaireS	ä¼Šå°‘å¥³
GuanchaNewMedia	è§‚å¯Ÿè€…ç½‘æ–°åª’ä½“
RbIIKFKMTHsGH	æ—æšå€«
BLACK_whitepino	ãƒ”ãƒå›
yCGTSjNbJWgmz	æƒ³ä½ å¾—å¤œ
TtFeimaotui	é£çŒ«è…¿
taropocky	è«é­¯è²å¯ â—¢
BtRKBYgJEWQQonS	æ·¡å¿˜ä¸€åˆ‡
joomi	å•¾å’ªç¤¾App
toushan_Bai	ç™½å¤´å±±ğŸ”¥
kao	é«˜ç§‰é´»
MetalEnglish	ãƒ¡ã‚¿ãƒ©ãƒ¼ã®ãŸã‚ã®è‹±å˜èª
anchalboy	é›‘å·¾ã®å¦–ç²¾
KhZBXVqsOtAF	ä¸€åˆ‡ä¸ºä½•
IGNHjGxngicLH	è¶£å¤šå¤š
FWViSCkkYuHSGTq	è‚–é¸¿åº†
Nolf_AntiCCP	æ— äººæ°¸ç”Ÿ
MuMu_	å–µå§†ğŸ¡
PRQKIiBoTioXzA	æ—è–ç¿”
iFitStar	é¡¾å®‡è¾‰
Y_AN_G	ä½æ½®æœŸå¥³æ€§
Char_Siu_Reila	å‰ç„¼ãƒ¬ã‚¤ãƒ©ğŸ¥•ğŸ’«ğŸ
Lin_Jing_bot	æ—é™
_MuNianCi	ç©†å¿µæ…ˆ
dabudong	å¤§è¡¥æ´
xumengjie	éª‘ä¸€å¤´ç¬¨çŒª
dzjsqy	ç´«è«¾
