ringo	りんご
kano	かの
tama v	たま
anko	あんこ
ken	けん
aamajgp	あ
suntory	サントリー
hana ap	はな
pon pon po po  pon	ぽん
tomomin	とも
chan	ちゃん
haru haru	はる
hirorin	ひろりん
ringo	りんご
momo	もも
sasasun	ささ
ponponpon	ぽん
rin	りん
nya	にゃ
kura	くら
pomu pm	ぽむ
a   sy	あ
kurumi	くるみ
ponpon	ぽん
azu	あず
tamakao	たま
rara	らら
hinan	ひな
him o	ひ
yuya r gn g	ゆ
paru   i	ぱる
ruru puzzle	るる
