luce	さすらいの健康マニアよしだ
pupu iz	ぷあちゃん
p miyako	都古なつメビウス公開中
konoe	このえ
s i n	しんくんケモ着ぐになりたい
ba	りゅや
u	ゆりえ
second	けん
qupbw	アッシュ
kenta	筋肉成長中
reiwatomo	店長妻暴れ子供との日々の戦い笑
tears	修行の旅に出る
lycaon lycoris	リカオン
shian rd	しあんゲーム因果律公開中
amore ali	敬
mekumeku	朱里シュリ
syu n spt	しゅん
kxg	山翠
haro dan	りょーたハロスイ男子
hurosuto	フロスト
ko ykii	狐雪発声
shio  ddd	しお
sorah	そらまめ
m   g	つむこ
a	近キト
hatori	はとり
s ab on k	サボン
chihaya	きいか
ao gcekhauv	あおにゃん
a	風来坊暖かな人脈を築ける新たな副業案件
kuroha	ゲーム垢
torc	りゅう
obake	れい回組
killo	ペズちゃん好き
strm	るあん無主属
snyans	ため息
mashiro lio	真白莉緒
jaimmyer bot	ゆめいっぱいの呟き
arnold second	アーノルド
yukorin	ゆこりん
yacchin	やっちん
sznsk	ふれあるーじゅ
alfred pbot	アルフレッドペニーワース
ukatujyu	迂闊十臓チャクラ監督
ipn np	磯野
olkzqyww	暇人デリヘルヒップチンポオッパイせふれ募集せふれ募集垢出会い系
kuromu	きせのん
sutou	須藤良仁
kki sshu	きっしゅ
a	幼红之月
sinsan	しん
tommymarch	トミーマーチ
tgrsk	栂里つがり
hiroaki	中川博照
sennou	せんのう燈霧炎
maple dayo	メープル
koyuki	コユキ
shinchaner	のはらしんのすけ
s nf kii n	すなふきん
mtsg znf	みた
yktrd	うきゆ
sukebeaki	すけべえあき
h mitsuhashi	みっちゃん
sinogi	たっちゃん鎬しのぎ地下ｱｲﾄﾙｦﾀ卒業打ち活はしたい
kisabu	いっしきくん
sskk	さまる
tellme	てるみー
mktg wizard	まほウェブ
bono	ぼの
i t	ダークグレー企業配属のれきイさん
pegita	ぺぎたメリーメリーうしました
litsu f	リツ
marukome z	まるこめ
koriyuno	こりゆの豚
rouka tl	すぐ忘れる残念な人
ar o c tq	モフ
cbhuman	こんばすちゃん
risalatoon	りさちー
ume chake	もと
krhr	塩米
ntsgr	なつ
d b	テト
kgm mer	きあ
chen cheeeen	ちぇーん
paparu	おおはる
chinori	ちのり
schiilc	さち
sunki	ヌニキイケメンだね月日から低浮上とか言ってたけど全然低浮上じゃない
ryu	さんすき
gekisousya	激走
shinkeihan	しんけーはん
spsut	はまちゃんチセイもととも
tknsei	筑音
ssss gt r	さおとめ
funi th	ふに
kensuu	けんすう作業配信を流行らせたい
okdosm	おさむ
okuson	ｽﾃﾗを騎空士ﾊﾚｸﾗ
ryutoukisi	龍刀騎士またの名は電遊侍
holly o	オキシジェン
kq jtae vi z	ゐ
kros	黒瀬
funky	ねこま祝タイバニ期確定
mo yeah shi	もやっすぃ
gekisousya	激走
maruru ururam	マーッーサル婚活日常
ksanr	忠実隊
st rhea	セントレアシェーグレン闘病中
hrtrci	すん
amnkri kzk	あまねくお絵描き
somizumizu	ソムリエ
dam cellean	ダムダム
rinoaniki	リ
a	べー
icoyan	イコやん乙アカウント趣味系
s ak ak i	眞田伸廣
sorano	ユキ舞浜出現率高
s as ki a	下町の抹茶第一子妊活
kznk	かずのこ
chii ro r t	花里知紘ちい応援専用
sunki	ヌニキイケメンだね月日から低浮上とか言ってたけど全然低浮上じゃない
shunka	ありさかマン
ikkkt	酒子
fubuki	日野きりあ
kinkin	まっ行ける冗談
sangon	さんごん
bunmaro	ブンマロ
wabirukai	ワビル改
l yq	はるか
koushi	高志
hg	平木
kenpi	けんぴデザイナー
g b	クソメモカス太郎
keyaki	笹山登生
vol	ぼる
kb uch	壁打ち
mo rifgo	もーりー
baction	ばなな
snmy swn	篠宮
sora s	そらさん
g aa bnote	そらいろ食べ盛り
s hi ma no	しまじろう
kizaki	希崎ひねも
kdash	悪くちジジダッシュ
basasi	五十嵐ちの
kanda	愛
ishiinoboru	石井昇
ycrss	ゆず
o k an as e o	叶星
yabaiyo texyo	ビットインコさん
a	祐哉
kenniko	ケンニコ
sidoon	紫嫩ｸﾝ
i	狙撃手
hestia	ハル
fbbafa	サバ介
yuta photo	白河優翔
koukou	こぅ
vagamoribon	吾妻守耿
tsuroir	ヤポポポポポイハービモラ
u	うい子
myoken	妙見
torine	とりね
minorin	みのりにわりよこちゃん推し
nkymkzhr	ナカヤマ
so lcfc	聰
snow dd	年代洋楽ロック
meijin ta f	月まで勉強垢
mdk sl	円ｧ
koishi	小石
r om	おれお
hakuzow	団長万葉州
aozora	天ヶ瀬涼
m y	えむ
hi taso	ひぃ
mj	たまこ
toriru	とりるアイコンはかりんとう
exp	けいきゅしーめんす
kyosui	きょす
trsb	そぼろは墓の中
juttanno	奈
kecha ke	けーまる
se	さん歳
ryoko	なこ
onigiri	おにぎり
bntyh	おじ
lu	貞子㌥
tppgi	局長トッポギ
homura	焔
spuupy	沖田円香
mr	真志まゆき
ss ol	黎
menchi	めんち
gmpas	ひかまる
shiok	ちお
karu j oy	カル
kros	黒瀬
s e xp	系編成急行千里中央行き
snowy owl	シロフクロウ
kelchan	けるべろす
na chaniro	なーちゃん
ryutoukisi	龍刀騎士またの名は電遊侍
keika	螢火
p piyo	ぴよ
hinocchi	ヒノッチ
sango	清雅二人は天狼星
oe	臓物
nihashi	慮華むいみ
naruko	血餅補給を忘れるな神戸なるこ
m b	捨て猫しゃるフォトナではなの
sou ao	奏
ryokomao	りょうこ
stepney	ゆみや
miso white r	晩のだいこんみそしる
tkn snk	すのこ
hey	アッキ
tisbd	コナメダ子ｱﾝﾓﾅｲﾄ箱推し
anju anjujp	安珠写真家
fru	井関ゃ白色パンツ
screaw	なの
hisashi	ヒサッシー
h e y p	推しプロフィール欄参照
mitsu blogs	御津甕
jatchimento	雪ん子兎
paruchan	まかろん
kouki r	コウ
marcysnet	骨付きまーしー
mirumirumiruno	ミルノ純
kae mp	江口洋介
raki yoa	羅葵
milk tr	ちぃはる
sekken	せっけん
hikorinu	ひいこ
ssaku	さつき共通テストに猛進中
g bf	救援依賴
homeron	ホメロン
i	リズ
a	たかよし
rikomike	いちご造形ゴリゴリ作る
yd r	三毛猫
konoe	剣コノヱ
tpkk	なお
okera	おけらコンパウンド先輩
s ky i oo p	セイ
tovfps	えっけぬ月日はコンブヤグラ杯
risalatoon	りさちー
keichn x	けゐちゃん
a	紡喜
ksrg	白兎如月白蘭
arinko	アリンコ
kedk n	かえでくん
st pr n	ねいにゃお迎え気づいて
fbbafa	サバ介
cokuru	くるよこ
r a f	杉山獅子党
shinonw	ゴミクズしのんちゃん
shu nogi	齋藤飛鳥推し
nec	ねこさん
omuraise	オム太郎ブログ評論家
mykwk n	そら
a	焔喪中につき新年のご挨拶は控えさせていただきます
ui kotatu	は
minipp	コタる
hikarin	ひかりん
ochin	おちん
parumu	パルム愛子でーす
p piyo	ぴよ
shutei	しゅてぃ
ykapp	庸
yorico nodoame	よりこ
chi rist	ねこおにぎり
sbk   o	み
c harupi	ハルピー
nish i na	仁科固ツイ見よ
yf	悠楓目指せ脱依存
reco mm	れこ
t ws t  y u	雀撫
s sbys ka	ぱれっと
nicolet	よしたん素人せフレ募集裏あかせックスうらあか中おふパコ動画オフぱコオフぱこ
hmlbot	ほまれ
l y	やに
shiori	受験生
second	弐
sh ma ntr	しまのっとフォロバ対面強化中
tazorix	タゾリックス
sbtntm	くろの
p iaq tt	ぽぷら
shpimuro	しばらく荒野出来ないしゅぴニダ
shine o	シャインフォロバ
wds	いまのあなたにひとこと
krns	ちきょっのお休み場所
okayu	おかゆ
mgsho	かぁぁぁぁ
zutomayo jp	マエダ
ryu	りゅっぴアシュ
parame	パラメ
sgkniht	すごくない人
stage xx	キュアジョージ牛グダー
ru shian	ルーシア
s a kimu ron	たも
y  r	仍
o gaku	ら
a	星座工場
hkhk	シキ
ho na mi	穂波
warrobotsxyz	神になりたい
kt ah uz tw en uc j	ひよこ垢
ryu	埼玉警備隊ラインバッカー
hn xxx	みとり大佐
hr ko	はとり
pupil	きゅうにかさなるくじゅうくり
sefira	スピリチュアルサロン
kxg	山翠
yuukccc	ゆうくん
locci c	じゅ沼のろくし祝単騎
a	サイガ受験知ったことか
sw	しわしわ
yoshi ha	乾燥美波
miroku	みろく
shoko	しようこ
osushi	すずな
bsick	かっかっキングスマン
make black	黒瀬かなと
yossyrhythm	よしぴー
sususu	スニッファ
okt	未来
wkwk  nn	みる
butacco	まーちゃん
spr a	せにょちゃん
wabirukai	ワビル改
mrsmao apple	まお
ssjmind	サイヤ
reccc	たかせ
ne romo t	ともぶるてあ
marikowymi	まりこ
kkugf	穀雨履修中
hnkn ssk	まゆちゃん
marukojyo	まる
dm gazumon	虹狐
kkr	すのピ
tpkk	なお
bntyh	おじ
aihpst	ハリネズミ受験生のため低浮上
konno	紺野ノンコ
f shima	ジアルチュー
eito vcm	兎すずちゃ超える
hromthx	はし
kiyo kxh	キヨこびと商店街出ます
ikrito	感謝
sksk	咲
thnsp	はじめちゃん
n  a	日々の生活
mskrsc	琴
naoki	なおき
shirai gc	上からみたナッシーら胃丼っくま油そば
shiwodo	しをなんかやる
kiri taisyo	きり
s n h yg	りっきー
ssss	さくちゃん
dskyb	そら
htkhsh	たまちゃん
dogend lost	ｲﾇ煙
zinnosuke	ジンモンスト用
m z	ツイフィございます
y o	ようこついかくさんして
korin	こうりん
kouya	ふふぉっ
kou s	こうじゃないかも
s g z	我那覇飛鳥
m   l  m  o o	びちょびちょ固定企画おじさん
shizuku	しずくぅ
riooou	リーオー
roo hi	希望の光が見えたわたあめ屋オンライカジノ
zakirenka	ざき低浮上固ツイ見て
tyabo	ユキジ依頼絵作業
nori p	のり
ruka mkd	るか
xq	ぶっちゃん
kns a bc	こにし
kiss k	ｷｽｹｲﾝｶﾍｳﾁﾍﾘﾀｨ
chino	ちのかっぷちの
aipo fujii	有豪通トラベル
sketo	うととん
skyuni	花垣うに
d b	ぼん之助の垢ボチボチ浮上
pupu  cc	ののの
kuroda	ちせ
nb nicomi	憂
ouha db	おは
tnb yh	やす
umekon	うめこんぶ
mobusu	トマト犬チャップ
maplecandy	みーお
akkys	あかり次回郵日
nuts umee	なつめ話線画
aozora	おじぎり
r  m	りょーた
hajime uoxo u x	すずかぜ
bt	スズメ
hodumi	ホヅミ
igtos	フレンチのおせちへと続く坂道
shigsp	多々良
kurara	追兎ぼ担
skm ag	朔間
dekapuri	ほし村
koyuki	心宮粉雪
aropin	矢吹亜朗
kyomer	もあ
naruto	和梨イケメンになりたい
snowno	腐垢
s  k  z	やっさん
koharu	小春とその仲間たち
mericom	めりんこ松リアタイ
ph hikaru	ハイカル
nnnnnn	なち
imu thunder	りんごにあ
omuraise	オム太郎ブログ評論家
oyksd im	涙の回転レシーブ
kikky m	こんきき
a	甘以あまい
ruto nuco	ると
doreminocola	ドレミのコーラモルック
seenth	しんぱっつぁん
r ui	ルイ
sekiko d	なつ
qlrrty	みずせ
von	ヴォン
m sh l st	たじエアブーファイル
ews	従藍而青
ohasi	墨
h k k k l l	ヒコリキコリ
wyokko	よっこ
s g z	我那覇飛鳥
blosm	ぶろっさむ
shishio gai	獅子王ガイ
cha shu	さまちゃん
sui obeh	翆
numbcha	ナムチャ復帰しました
kgsyd	なな
fkkcp	りぽぽ群馬
l tsip	あん
shochan	まにゃ杏
nbsmac	マック
marixhonya	鞠
mizuharashou	翔
kinaco factory	らる
nns d ff	ななす次はいつ
sloth	影ノ鬼翔太郎
wk	わ
sin ruka	ねこさん
jmukk	トワマ
ppot	ぴぽち
sekka	雪華
kikyou	ききょうめろん王子さまのペット
li tw	リ
yng kikaku	ゆうなぎ
garyu majang	蛾竜提督雀脱ジャンヌのアトリエ
non e t	のん
doooon	み
tks	たけし
okire	さくらんぼ
th rainy	特級鵺型情報生命体
karula	カルラ
morimori aku	もりの
i  k	いを
ken ishimal	イシマルケンイチ
kirito	宇良さんプリコネまでガチャ禁
mizyunoowari	くつした
snpr	せんり
kurosan	にゃあ
k s bh ai	そた
sisiku	咲枷シグ
kv u	アスカ
ko gohx	うみ
kaichi	かいちゃん
anubisuvrc	ファラオ
charo	みいな
o ae f go ac	エイ
sxe	シェルビー
spi saku	さくありがとさん
suicdio	不知火
morigami a	森上晶
shinoboo	しーさん
xt	玄米ぶらん
panda	いちごろ
plus mm	みみ
fu yuki iruka	ゆき
gh	遊雨ウェン
shizuku	桜坂しずく
s tr on gmzmr	水森
r mi	りずみーる条件垢
shining guy g	明るい害歯
ne	ねづみ
ha	いさに
hinarno	ヒナーノ
obake	オサャレ魔女しけしけ
sin ruka	ねこさん
midorimimi	みどり
r i n a	りーな
gz	じーずナノ友ナノ
yomekoara	渡嘉敷たぬどん
shieru chan	男の娘投資家しえるちゃん
shioaji	シオアジ
daodaow	だうちゃん絡み重視
r om	だし巻き
mikipi	名古屋
ka n b al	眠り兎
meimei roses	ありちゃん
osugi	パルメリ無
nngs q	森に帰りたいだけの某なにがし
tanri	はる
fashu	古栄
hgi	萩
chikushi	筑紫哲也
gucchi	むらかみもえ
yomosu yeah	わもすけよもすえ受肉した思念体
kuro mr	くろ
sonohi	千円均一古着屋ソノヒグラシアメ村店
shokichi	イチゴの国の正吉
k hiro	かつとし
mmmmmuimmmmm	わたまる
quwro fx	雫
zumsoo	イアン
charisu	ちゃりす
m x	もこ
nibuchannn	ニブダヨ
a	がげん
kkunn	けーくん
rim	りむ
ishi kokushi	寝不足お医者さんの暇つぶし
lix	りっくす
ssss	み
z o h	おだくみ
syouhosinen	少年
ni	コブダイ
pue	りぁこ
hikaru o	佐藤
kayoppi	おかよ
saiko	蒼の人三密回避中
namepuri	なめぷり
voidmayuta	繭太妄想
stepney	ゆみや
ken oo	大塚健けん
m kr kra	いくらちゃん今は相互フォロー制限ナウ
nono	ノノ
hgi	萩
the musume	娘
kimi k t	きみたん
rui	ルイ
s t art	アート
pnimo p	ニモ
youmu yukuri	妖夢リアルダーバーガー
oneko	いちこん
y t	たいち絆月日からガチャ禁
nohivoix	のひ
sorry	ゆーゆ
soxlis	そりす
nein cho	寧猫固ツイ
tsuru m	かくまぬい作ってる
sumowns	すももちゃん
luv	うさ子
kiri mitz	伊敷
syk sal	サヤカ
charo	みいな
r  u   a	るあ
mypacedayo	さよ
h te te i	九州の家庭教師子育て
solh	かぼ
yumihariduki	七星零音
neko xx	アスカ推し
kbdmg	呪
keyaki	わかし
wktnsk	くららすがはらりこ
honpo	ほんぽ
shinba	芝
kaichi	かいちゃん
minsu mugimugi	雪
kurouo	まっくろ暁
gochi k	ゴチ
dngms	くさ
keikiww	けいき
bucchi i	ぶっち
rxu	りゅま
lemomm	不良風祭
tori d	コトリ次月
lancekorpral	兵長さんまで外出自粛中
wbu	そーくん
machiruruchi	まちるるんるん
kurisutaru	あっちゃん
hachan	ハヤーチン
gurifon f n	えでぃたーかっこかりのぐり
syo dayo	翔
a	ﾚﾝﾁﾝ
onsea	イルカｽﾃ日
kumi gbf	くみ
yoru	よつぎり
pigmin	いちご
mekubo	めくちゃん
koyuki	こゆき
about	くらい
yoru	夜廻よるてゃん
olet trailer	ポールトレーラー
kkn ne	身體がある心臓がある肝臓がある膵臓がある胆嚢がある肺がある腎臓がある眼球がある小腸
honoka	アクア気まダラ勢
ishi chan	いしちゃん制作
posan	ぽさん
minemori h	峰守ひろかず
go neko	号
vgs	なこ
onoshi	おのし
naoki	なおき
shinon	シノン
yoshi kiryu	明佳
i	今週もれちです
yoru	よながよしき
bros	ブロス
midoosyushi	お兄さん垢始めました
shino  bot	志乃
en s	のらさん
black later	公演横浜
gunoc	ぐのしー
soraran	そららん
gltak	ゆうま
shifuu	紫風
soraran	そららん
i	パフ
naoki	メモリ
rino torihiki	りの
tgsrk	トガシ
kth risuu	理数
gs bot	ナルミツコピペ
n naoki	祢津直紀
kyouk k	郷花
dpc misa	実況用りだずの幹事
h    a	ひちゃん
syau zia saya	しゃう受験生
a	逢子
neppu	きたみ
rktja	とある田中産
k ei	遺屍
yossan	よっさん
kuroh	黒浪
ne	パピヨン
b jq	ばばゴン
luv	いく
nishinihon	ワパワパのンフ
ssmypp	刺身
gnuuuuuun	爽健美茶
marino gt r	黄昏マリノ
cir uxd	いちる
m r	歩くみやぎ県
ibu	ココナッツ
mr	真志まゆき
tharu	ぽむ
hinako	なつみ
stky s	時屋禁
ntine	るさ
hachi fd	はちみつに近い生命物体
moomin mama	むーみんまま
n naoki	祢津直紀
flowercage t	カリーナ宝塚中毒患者
paint	みかん
mruku t	みるくですぅ
rta ptg	りたぁっ
zyaga magic	ハタケ
ria	りあ
y rt	ュュ汰
tae  popipa	花園たえ
ka kun	かーくんギフト企画中
kirito	きしりとる
oyachi	オヤチ
flowersmoke	華煙
summer pad	もんぴー
wsfv	くまもん闇の魔獣サンシャイン山田
mmktomato	ま
hippii	ひっぴー
yomogidada	ヨモギ田一モギ助
okitsunomiya	沖津宮
krnn a	早苗
karahi	からし
terelamp	てれらんぷ
mkrn nnn	もくれん
odoro	危ないサル
sapibu	さぴぶい
yo	の病み垢
sinkan	新刊
kurais	けい副業アカ
dora ms	ドラえもん
y ri	梨
speta	すぺくたー
yo	める新刊通販中
tyan desu	黒い彗星
shun yukkuri	しゅんゆっくり実況者
ghkiqq	ささき
h os iu mi	狐面の一般人
emmet sky	エメット垢
morimorimyu	せちゃ
yuka yudachi	夕雨歌桜姫
mariko s uk iy	マリ好き
mariko s uk iy	マリ好き
n ek	どんリトルボーイ
yami renchon	人生に病んだれんちょん
kicchin	きっちん
vn	田老師
kiritov	カミト
knkmc   r	きなこもち
h  ra	ｧ
fuka zume	深爪人中おばけ
sin phi	ファイ
t ei ou fate	あけおめ
kyoeku	けーあい
corona	ころな
y rc t	ねこやで
nd ih	なみ
yume hatsune	ハツネ
wsrkmw	蓮樹ルイるいそ
d omrs	好
soobi	ﾓﾓ
mazin s klbot	マジンカイザー
imas cg siburin	みずなな
s p k ts	ポテトきゅん
carol	リュ
hefmhgg	お姉さん通話まんこ裏あか女子せふれ募集精子尻フェチパンツ
u kks jt	ゆゆ病み
hollyhock miss	ぽち㌠特級過呪怨霊とぉ常駐おばけ
mashiro cruz	来須ましろ
oasis	なぎもん
miracle candy	ミラクルスイートキャンディ
ytr w	ゆとる
y           d	みきゆうだい
mari rusalka	くじょー
z io	ななさと
mbs sk	松星企画
bansyousan	森羅万象
hoyou me	スレ抜粋試運転
kankoku media	閑刻メディア
srmr gm	しろまる
soudai	宗田威党
sino ccno	しの
pt rat	げっこー
u	短歌
ku sa ri	鎖音くさり
higoromo lensu	ひごろも
raykcp	レイ
s no iro	そら
kenchan	ケンちゃん絶賛工事中
hknk	箱猫
nove	延
kuroha	涌谷こがね桐生会やさぐりゃー
ss hiroto	ひろと処女卒業支援
sino ccno	しの
hn	のヒノちんこ
kimurio	凪咲凛音
newgoodz	最新グッズ情報
icepail	白星
taijiran	奥磯太覚おくいそ
marupi waa	まるぴ
chescere ship	ケイト
btmwk hy	型
kmmmmmmmmzz	みーくん
sg	もつ
kouyan	あ
chikako	矢澤知嘉子
viatoriaya	ジュフロワ
te te	ぱちもと
kiritov	カミト
puentu	ぷんえつ
ykabck	はるこ
tkkp	何もない
pisuka	あたらき
nsr tt	みほりーぬ追兎
mariko s uk iy	マリ好き
angelpppbig	ぷりんまん
miruku miru ame	飴
kuromu	空川クロム低浮上
z z	ゴミ蔵
torch	とろろろろろろろちん
yan deyansu	やん
spnry	タニシン
honoka	うなぎ
a	星座工場
nisoku	にそく固ツイアンケあります
mkr rkm	枕
bacho	ハル
ztmy  sk	どくろ
kouga	そこら辺の中学生
koshi	坂田幸志朗
puni ff	ぷにちゃのちゃちゃちゃ
shin iro	しんぐさりたい
nira tch	ニラニラはにゃんにゃんエンジニア
chihaya	きいか
gonzo	ごんぞー
ojisama a	年月日時になりました
oh rice	お米
si miso	ミソ
rokun	ろーくんサブ垢
dli	ｽﾗ仏
miroku	魅勒あと歩で覚醒せし者
kenpity	たくふぁんけんぴ
fuka gray	不可不可不可
rukamaruuu	流夏
snrk	ルッコラ
mikiya bot	鷹山三樹矢
ryuttaropi	りゅーたろー
waa ppp	ぺんぺんこ
sypdkm	なつひぼし
rspn	いとう
puromu	かずゃぱぱ
xknono	すやすやゆいか
shu dollaz	歌う元駅員ｼｭﾀﾗｽ
miyalocked	美夜
stroheim	でんすけ
kijoban exvs	きじょばんよしこ
nino  cha	にのってら加速オン日目
yuposo	ゆぽ
