amaimono no	甘いもの
animejikkyobot	アニメ実況
tsudayan	つだやん
jo nico	じょにこ
ayu ko	鮎子
mashiroharu	ましろはる
mana	まな
mochi usa	餅うさぎ
hirota vg	ひろた
oionigisi	おにぎり
uisawashigure	憂沢時雨
nameneko	なめ猫
kazuma oshiro	かずま大城
ittyan	イッチャン
namahamuchan	生ハム戦犯
himuchi	ひむち
hiimii	ひみ
eite	エイテ
sakibeeei	さきべぃ
momose	百瀬
kashiwamochimo	かしわもち
