tsudayan	つだやん
mashiroharu	ましろはる
mana	まな
uisawashigure	憂沢時雨
nameneko	なめ猫
himuchi	ひむち
eite	エイテ
momose	百瀬
shibayan	しばやん
kanayamayika	金山由佳
ribon	リボン
fon	フォン
poyoko	ぽよこ
sakoko	さここ
kuroanco	くろあんこ
na	ナ
rendian	レンディアン
oshimat	おしま
umiuma	うみうま
taka	たか
machisame	町雨
aniradi	アニラジ
zuiro	ズィロ
aipon	あいぽん
hiyo	ひよ
sekai	セカイ
kyome	きょめ
yasumattechan	やすまってちゃん
oitan	おいたん
ri	り
hiname	雛芽
buronto	ブロント
hoejika	ホエジカ
hitomi	ひとみ
karaza	カラザ
ma ikayo	マジカヨ
nakachanman	なかちゃんマン
hinaki	ひなき
hoshinome	ホシノメ
kuroyuri	クロユリ
nakajimak	中島
deaiwomotomete	出会いを求めて
kaneyanaoto	かねやなおと
tokumewi	とくめい
mikuto	みくと
shikizakura	四季桜
kusa	草
nokko	のっこ
toriusa	とりうさ
pachi	ぱち
pannomimi	パンのミミ
menokumo	目ノ雲
zatsuzakana	ざつざかな
moguchi	もぐち
haniwa	はにわ
shironiji	白虹
ai	あい
syashin	写真
kakeyoruaichi	駆け寄るアイチ
nuretaoru	濡れたおる
tokumewi	とくめい
shin chan	しんちゃん
punyanyas	ぷにゃにゃす
nerooren	ねろおれん
nishiki karuta	錦カルタ
dandan	だんだん
sakuradori	さくらどり
otose	音瀬
hachi	はち
takiren	たきれん
kurashiro	倉城
reogiku	レオギク
ebi	エビ
yatoo	ヤトー
hiyori	ひより
mina mi	南
aya	ぁゃ
nasa	なさ
maehoma	まえほま
kuroichi	くろいち
natsuo	なつお
ka	か
erumisu	エルミス
kinocoma	きのこま
bayashi	バヤシ
aki hie	あき冷え
kawahira	カワヒラ
meguminokamisa	恵ノ神様
saya	サヤ
burita	ぶり太
hiyok mame	ひよこ豆
yorushin	夜珍
sayona	さよな
tadanominami	タダノミナミ
aya	あや
potetoichiro	ポテト一郎
yuyu	ゆゆ
sanzouhoushi	三蔵法師
resyoku	れしょく
satousiro	砂糖白
yumenami	ゆめなみ
shirona	シロナ
nijilogu	にじログ
nonono	ののの
yukito	雪徒
koinobori	こいのぼり
suzuri	硯
run	るん
hakkan	ハッカン
sayako	さやこ
haru	ハル
okakuro	おかくろ
kuro fuji	くろふじ
hanayamakaorunn	花屋まかおる
kinopi	きのぴ
main	マイン
chiipapa	チーパパ
chiximyon	ちぃみょん
omina	おみな
kopi	こぴ
iyosetoka	伊予せとか
tokoton	トコトン
amya ruru	あみゃーるる
piyoko	ぴよこ
kanzakip	神崎
osarunosu	おさるのす
t oruchan	とおるちゃん
boyakenasu	ボヤケナス
kurogo ma	くろごま
mirai	未来
takayuki	たかゆき
yokohamab	横浜
tsubaki	ツバキ
airin	あいりん
yuri	ゆり
yuno	ゆの
katsuya	かつや
owarishima	終島
sumi hari	すみはり
koko	ここ
natsu	ナツ
tomo	とも
shigu	シグ
haru	はる
omarisan	おまりさん
anmochizouni	餡もち雑煮
warabi	わらび
ayapero	あやぺろ
yata	ヤタ
nintentou	任天党
ayumukkun	あゆむっくん
suzuki	すずき
punzatsu	ぷん雑
yuni	ゆに
kuro fuji	くろふじ
tubamen	つばめん
shakechann	しゃけちゃん
nisizawa	西澤
runjirou	るんじろう
marina	まりな
maorosu	まおろす
usushio	うす塩
adoria	アドリア
hasera	はせら
arare	あられ
nun	ぬん
yokochanhonpo	よこちゃんほんぽ
maguro	まぐろ
ere	エレ
ringoame	りんごあめ
ayarulu	あやルル
non	のん
kokui	こくい
etokaman	えとかま
rina	りな
nao	ナオ
shigewo	しげを
ninjabashiri	忍者走り
memento	メメント
piruku ru	ぴるくる
haku	ハク
chiyume	ちゆめ
hanku	はんく
gegegenomosuke	ゲゲゲのもすけ
noinoi	のいのい
kirierenko	きりえれんこ
mitukiwa	ミツキワ
maaya	まあや
kumine	くみね
buran	ぶらん
sumiso	すみそ
kirinoorehana	霧野俺はな
kanatax	かなた
han chan	はんちゃん
matsuri	まつり
shigechan	シゲちゃん
mogu	モグ
sakeonigiri	さけおにぎり
genzaisuiryo	現在推量
ria	りあ
miu	ミウ
kanzakiouka	冠咲オウカ
nao	ナオ
tougeno	峠野
yoga	よが
niboshi	にぼし
ria	りあ
onteion	オンテイオン
mame chan	まめちゃん
yamada	山田
arare	あられ
kareepan	カレーパン
soramame	そらまめ
nna	んな
hisa	ひさ
mei	めい
satou	さとう
kaiton	かいとん
ame	あめ
kurose	黒瀬
ramuko	らむこ
uzumakinene	渦巻ねね
manmaru chan	まんまるﾁｬﾝ
syougikakugenn	将棋格言
akubi kun	あくびくん
ruina	るいな
kazuki	かずき
yagami	八神
kitakbu	きたく
mame goma	まめごま
yaku	やく
yoda	よだ
moritang	もりたん
maru	まる
minechin	みねち
nidosuke	にどすけ
hinatahinnka	ヒナタヒンカ
sakanamori	魚森
purioji	プリおじ
saburin	サブリン
yumi	ゆみ
kinuho	絹保
tsuchitsuchi	つちつち
sashimin	さしみ
mono	もの
haluurara	はるうらら
muchimaru	ムチ丸
oubi	おうび
nisidadaisaku	西田大作
hodenass	ほで茄子
bebi	べび
hazama	ハザマ
hiyamugi	冷や麦
sayumin yosikawa	さゆみんよしかわ
giyo za	ギヨーザ
sunato	すなと
aki hie	あき冷え
ri	り
marokun	まろ君
ruina	るいな
okametsumamiya	おかめつまみ屋
tomo	とも
wintamu	うぃんたむ
kapisuke	かぴすけ
kohaku	琥珀
masayoshi	マサヨシ
taima	大麻
guratangou	グラタン号
ikurachan	いくらﾁｬｧﾝ
tan tan	たんたん
marupo	まるぽ
nomizu	のみず
hanayamakaorunn	花屋まかおる
modumin	もづみん
kikuchi keitarou	菊池啓太郎
kanata	かなた
wqtagashi	わたがし
rukibe	ルキベ
usamemasanobu	卯鮫正信
kanakyu	かなきゅ
itoyaxi	いとやぃー
kurafes	クラフェス
sasurai	さすらい
chi animeaka	ちアニメ垢
hapi kun	ハピくん
nuknounmo	ぬのうんも
nobuakira	のぶあきら
ayayan	あややん
higashikata	ヒガシカタ
aki	あき
yoshitune	ヨシツネ
gansekiw	ガンセキ
kaorin	かおりん
yawatako	やわたこ
shirei kan	司令官
rizume	りずめ
edakichi	枝吉
renamaru	れなまる
ameusagi	雨うさぎ
yuha	ゆは
tanishi	ﾀﾆｼ
kikusan	きくさん
kanata	かなた
hideki	ひでき
momin ji	もみんじ
sato	さと
kinkirahoipp	キンキラホイップ
kensuou	けんすおう
reo	レオ
kajiki	カジキ
makai	マカイ
yuusan	ゆうさん
suzushi	すずし
hiori nyan	ひおりニャン
sakura	サクラ
itatsu	いたつ
hokahokamanjuu	ほかほかまんじゅう
guchiyama	くちやま
ranmaru	蘭丸
konekochan	子猫ちゃん
yuru	ゆる
nowa	ノワ
shishamo oishii	ししゃもおいしい
myurara	みゅらり
machintamu	まちんたむ
esekansaijinda	エセ関西人
iadan kopipe	イアダンコピペ
yayuyo	やゆよ
ichimtsu	イチマツ
yamachan	やまちゃん
fukenkou	不健康
furuido	ふるいど
yakumo	八雲
tomochi	ともち
yuzu	ゆず
amamiyaritsu	雨宮律
tai desuyo	鯛ですよ
ripu gonzaresu	リプゴンザレス
asunaro	あすなろ
hisui	ひすい
migozuku	みごずく
hangorolin	はんごろりん
robo	ろぼ
bou cha	ぼぅちゃ
juju	呪呪
takopoco	たこぽこ
zura	ヅラ
orusuta	おるすた
shinosuke	しのすけ
tama	タマ
mimi kyu	みみきゅ
mikuteku	みくてく
tama kujira	たま鯨
tomozu	ともず
yapi	やぴ
kurogoma	くろごま
matsuko	まつ子
miya kazu	みやかず
nikuo	にくお
yuzukichi	ユズきち
heyakita	へやきた
wase	早生
kurowa	くろわ
denomotan	電おもたん
mizuno	水野
daizu	だいず
hitomiiko	ひとみいこ
yukineko	雪ねこ
aru	ある
takana	たかな
nakken	なっけん
chihomi	ちほみ
sakura	サクラ
itaden hanamiya	イタ電花宮
senbexe	せんべぇ
emoto mashimesa	江本マシメサ
womuretu	をむれつ
yakumi	やくみ
minisere	みにせれ
aoharu	アオハル
yukimushi	ゆきむし
raputoru	ラプトル
rikunagi yuu	陸凪ユウ
akiho keiba	あきほ競馬
pehede	ぺへで
kaeru usagi	蛙兎
yatogami	やとがみ
narasann	ならさん
rukichi	ルキチ
pan	ぱん
purikun	ぷりくん
munpapi	むんぱぴ
ikumi	いくみ
shino	しの
nasumoku	なすもく
mana	まな
dozounonyaka	土蔵のにゃか
konkou	こんこう
nousu u	ノウスウ
mikuras	ミクラス
ao	あお
inori	いのり
podenkun	ぽでんくん
yachui	やちゅい
usakokaeru	うさこカエル
dakkonn	だっこん
paku chi	ぱくち
yuusuke	ゆうすけ
hirota	廣田
sakiika	さきいか
mihochin	美穂ちん
yotsuba	四葉
nagi	なぎ
makaron	マカロン
noppe	のっぺ
kanakichi	かなきち
holoukekamui	ホロゥケカムイ
saihosi	さいほし
darayama	ダラヤマ
namappe	なまっぺ
maki	まき
runjiro	るんじろう
yudecchi	ゆでっち
okazora	おかぞら
asupara	アスパラ
kaju	かじゅ
hakumei akashi	薄明アカシ
shichi ka	しちか
nishipppe	にしっぺ
myau kikaku	みゃう企画
siriusu	シリウス
take	たけ
hime	姫
npapapa	んぱぱぱ
erika	えりか
sakurai itsumi	櫻井いつみ
unko kunimi	うんこ国見
ittousei	一等星
mikuras	ミクラス
kuroimegane	黒井眼鏡
kakinyako	かきにゃこ
inukisi	イヌキシ
niwasan	にわさん
ayami	あやみ
kiichi	きいち
kiyu	きゆ
mikirukate	生きる糧
donkyuusai	鈍九斎
aika	藍架
zazaboon	ざざぼーん
kieiro	きえいろ
miyatake	ミヤタケ
tujimori	つじもり
sakana	さかな
mito	みと
ryokucha	緑茶
nacchan	なっちゃん
aoi	葵
nekozoone	ねこぞーん
haruurara	ハルウララ
kesera	ケセラ
noazami	のあざみ
sugita	スギタ
moko	モコ
juri	樹里
kungisa	クナギサ
konkaron	コンカロン
ayaha	綾葉
punsuka	ぷんすけ
aruchan	あるちゃん
tamura hiyori	田村ひより
panme	ぱんめ
lokimaru	ロキまる
gizura	ギズラ
momodaisuki	もも大好き
nanaonao	ななおなお
danna	旦那
macha oji	まちゃおじ
yatohana	ヤトハナ
katsutake	カツタケ
shiba touma	司馬当麻
yui	ゆい
mao	まお
cho san	ちょーさん
santamama	サンタママ
yoshimizu	よしみず
narita	成田
toro	トロ
umi	うみ
seriha	芹葉
chocoru	ちょこる
tomocho	ももちょ
miu suzuriha	ミウスズリハ
kasugasumomo	春日すもも
yoshitaka	よしたか
hinaki	ひなき
yuzuki	ユズキ
kimidori	きみどり
ankou	あんこう
kanpan	かんぱん
mukkoro	むっころ
piroshi	ぴろし
miso	みそ
yuipyon	ゆいぴょん
kuzumo	クズモ
tomomo	ともも
tamago	たまご
tamo	たも
nashiko	なし子
ra gora	らごら
mihopapa	みほぱぱ
myouga	ミョウガ
drakuro	ドラクロ
soranomameko	そらのまめこ
furemu	ふれむ
natsuisara	夏井さら
guhehechan	ぐへへちゃん
yayoi	弥生
kiritani hitomi	桐谷ひとみ
ryuka	リュカ
nayuki	菜雪
hasuwap	はすわ
ichino	いちの
mayu	ﾏﾕ
fukapyon	ふかぴょん
kyanoru	きゃんおる
nou	脳
danmaru	ダン丸
renon	れのん
kagetsu shion	花月しおん
bukininn	武器忍
yuzu	柚子
yukiyuna	ゆきゆな
niiwa	にいわ
mizuki yuri	水樹百合
sakuranbo	さくらんぼ
kojo	コジョ
yun	ゆん
ata	あた
pupipo	ぷぴぽ
motunabe	もつなべ
ochatousan	おちャ糖まん
inupyon	犬ぴょん
tukimisou	月見奏
hina	雛
matubara	まつばら
micha	みちゃ
fuwafuwasan	ふわふわさん
irugisu	イルギス
tomtanaka	トム田中
takamaru	たかまる
fuyu enoki	ふゆえのき
ushijimamasato	牛島正人
samidaresensei	五月雨先生
yamiwa	やみわ
kado mi	かどみ
geba	ゲバ
ta kuro	たくろ
asagiri	朝霧
shizu	しづ
yupiwo	ゆぴを
kagami	鏡
aki	アキ
sawa	サヮ
shiratama	しらたま
zono	ゾノ
bei	べい
sora	そら
takamarusuisan	たか丸水産
amen osora	あめのそら
seironsennsei	正論先生
dorukuma	どるくま
mio	みお
roku yuurei	六幽霊
mameta	豆太
masapou	まさぽぅ
kogepink	こげぴんく
kojika	こじか
unngoki	うんゴキ
airi	あいり
furifurimomo	フリフリモモ
yokubarisu	ヨクバリス
medi aka	メディアカ
yo ssan	よっさん
mayotuna	まよつな
saki	さき
kozue	こずえ
nohito	のひと
otsukenn	おつけん
akaneko	あかねこ
suzukaken	スズカケン
yosirin	よしりん
shigao	しがお
usataivu	ウサタイブ
antananarivo	アンタナナリボ
kaze	風
soryonn	そりょん
tanayuki	たなゆき
shizuru	しずる
yumemakura	夢まくら
azumine	あずみね
rupipon	るぴぽ
haineko	灰猫
kaguhakobi	家具運び
shunta	駿太
sakuraoi	桜葵
haybusa	はやぶさ
kakko	かっこ
nasu bi	なすび
toki	鴇
mekajiki	めかじき
amakusa	あまくさ
nimono	にもの
ramu	ラム
shitami	したみ
amemiya byakuya	雨宮白夜
suzaku	スザク
jinrakuaiichi	人楽愛一
kimayun	きまゆん
so machin	ソーマチン
fuyuyu	ふゆゆ
satori	さとり
kino	きの
daiki	だいき
onekun	おねくん
totomagg	ととまぐ
saba	さば
sakusaku	さくさく
kurokome	黒米
muumi	むぅみ
amin	あみん
yoshikawa	ヨシカワ
kamikitakomari	かみきたこまり
yuina	ゆいな
ayagakiyuki	あやがきゆうき
shigure	しぐれ
yukikaze	ゆきかぜ
neko majo	ねこまじょ
ari	あり
kaede	かえで
chinta otamu	ちんたオータム
rokka	ろっか
kinkirahoipp	キンキラホイップ
meu	めう
haibikun	ハイビ君
tamamizu	玉水
yuumi	ゆうみ
rio	りお
haa	はー
pyoko	ぴょこ
kiina	キイナ
risanav	りさな
mahama	まはま
chomu	ちょむ
yunyunp	ゆんゆん
takahashinameko	高橋なめ子
nano	なの
kokonotu	ここのつ
metappou	メタッポウ
ka royoshi	かろよし
onikure	おにくれ
heki	碧
kamemoto kie	かめもときえ
shigure	時雨
ahokusa shirou	あほくさ四郎
kokoroko ko	こころここ
miyukin	みゆきん
kozakku	コザック
daimaru	だいまる
choko	チョコ
aina	あいな
sousuke	そーすけ
hiyoko	ひよこ
rio	りお
sana	さな
yamashiro	山城
kanakeke	かなけけ
bangren	バンレン
umeko	うめこ
urusaishiwasu	五月蝿い師走
shinohara	しのはら
kurorone	くろろん
aabakadana	ああバカだな
ejirin	えじりん
izakaya furuya	居酒屋ふるや
hiron	ひろん
shijimi	しじみ
sumomo	スモモ
nika	にか
maroyakana mizu	まろやかな水
aimi	あいみ
remi	れみ
tafuocu	タフオク
murasaki	むらさき
youshikibi	様式美
mugyugyu	むぎゅぎゅ
ukogi	うこぎ
makichi	まきち
natsu	なつ
masakishinya	正木慎也
usagisan	兎さん
fumi fumi	ふみふみ
kurinezum	栗鼠
amemiya byakuya	雨宮白夜
kusuriya tantei	薬屋探偵
maikun	マイ君
orurai	おるらい
kano	かの
chibiusachan	チビうさちゃん
haren	ハレン
hitochi	ひとち
tatsuya	たつや
ryu kun	りゅくん
miku	みく
nozepoyo	のぜぽよ
hiyori	日和
hisa	ひさ
takutakue	たくたくえ
marimo	マリモ
vorira	ゔぉりら
aiueo	あいうえお
imabari yuka	今治ゆか
umu	う無
dakkoara	だっこあら
yume	ユメ
manamonano	まなもなの
ajisai	あじさい
furuido	ふるいど
raratan	ららたん
momo	もも
au	あぅ
memochan	めもちゃん
noa	のあ
mogetam	もげ太
ima	いま
yayosun	やよさん
neko oyabun	猫親分
masaya	まさや
toragusu	寅楠
kantaro	かんたろ
toi	とい
bayashi	バヤシ
mongorungo	もんごるんご
guraemon	ぐらえもん
yunnbeko	ゆんべこ
takaten	たかてん
arechi	あれち
murapen	ムラペン
kiku	菊
naru	なる
bansan	バンサン
nireki	楡木
yuusan	ゆうさん
conayuki	粉雪
poka poka	ぽかぽか
akasaka	あかさか
taiyaki	たい焼き
pinya	ぴにゃ
aki	アキ
ikuyumu	いくゆむ
gajumaru	ガジュマル
tebasaki	てばさき
fukuchi	福地
murapen	ムラペン
yunakazu	ユナカズ
towa	とわ
asuparagasutaro	アスパラガス太郎
mineiyutaka	嶺井豊
nanona	なのな
damedamewanko	だめだめわんこ
kurotarou	黒太郎
ponzu	ぽんず
chika	知佳
kuma	くま
atugetan	アツゲタン
ikarimanatu	碇マナツ
gafatie	ガファティエ
genmaitabeko	玄米たべこ
atsuka	あつか
hiyori yuzu	日和ゆず
akimin	あきみん
ueeee	うええええ
ria	莉亜
izayoi	いざよい
na kajou	ナカジョウ
sasamegu	ささメグ
sayu	さゆ
kerorrin	けろりん
moe	もえ
warewaredan	我々団
yudecchi	ゆでっち
yukihiro nanaka	幸弘ななか
urisan	うりさん
kosuzu	胡鈴
ryu	りゅ
nanriu	ナンリウ
reri	レリ
mamemosi	マメモシ
nijiokasan	虹岡さん
goripon	ゴリぽん
kodoku osakana	孤独な魚
takenohana	竹の花
shigesyan	しげしゃん
moru	もる
nekomu	ねこむ
talutoru	タルトル
asa botan	あさぼたん
narikesoji	なりけそじ
naposhita	なぽした
shuri	シュリ
ayupon	あゆぽん
gitaharo	ギタハロ
dateatsushi	伊達敦
zakura	ざくら
ruto	ると
shiramizo	白溝
azarasi	あざらし
mi chan	みーちゃん
komachi	こまち
akashino	赤篠
buren	ぶれん
kanawa	カナワ
kouchin	コーチン
kuro	くろ
imokonnu	いもこんぬ
tachibanac	たちばな
tamanegi	たまねぎ
shikeku	しけく
peten	ぺてん
koke	こけ
metakuzu	メタクズ
ikenieg	いけにえ
miiko	みーこ
akirapa	アキラパ
denkichi	でんきち
natsuume	夏目
ogawajunya	おがわじゅんや
tougen kyou	桃源キョウ
egurin	えぐりん
moka	もか
kurotoriyuki	黒鳥ユキ
karasudo	烏堂
ebisuna	えびすな
nao	なお
minose	みのせ
wako shiro	和光しろ
tsukemono	漬物
utakata	うたかた
kisasan	きささん
karino	かりの
moka	もか
uminolemon	海乃レモン
kiriokun	きりくん
sana	サナ
moyamooyashi	もやもやし
omikan jirou	おみかん次郎
miiamaru	みーあまる
tookiboshi	遠き星
masuzow	ますぞう
kankore haiku	艦これ俳句
wasabi	わさび
chu	ちゅ
sanue	さぬえ
mitukuro	みつくろ
arukun	あるくん
meru	める
ayako	アヤコ
sena	瀬那
erui	ゑるゐ
nakaaoii	なかあおい
natsume	棗
toyamakyun	とーやまきゅん
tsuyoshi	つよし
izu makoto	伊津誠
mikage	みかげ
tsushi	ツシ
oruma	オルマ
moichi	もいち
buremega	ブレメガ
sayo	さよ
kuro	くろ
sibainu	柴犬
piyochiyo	ピヨ千代
aoyami	蒼闇
daiki	大暉
kurokamaboko	くろいかまぼこ
koyakoya	こやこや
kamo jinja	賀茂神社
minamonte	みなもんて
machaki	まちゃき
kuro	くろ
nyu sankinkefia	乳酸菌ケフィア
hitachi minato	常陸湊
kannonzaka	観音坂
tadano hanga	只野版画
hatori	はとり
souta	そう太
wachmaru	わちまる
wanineko	鰐猫
misagosan	ミサゴさん
migiri	砌
miyu	みゆ
fuyu	ふゆ
gunjou	群青
airakukaria	哀楽狩阿
poroporo	ポロポロ
hajikko	はじっこ
areumi	あれうみ
yanpa	やんぱ
