ragabsalim	رجب سالم
lliixi	طيف
TalabTalab	Talab Talab
mohamad_shwkat	MohamadYahyaShwkat
moa_sd	monعim
thedark	THE DARK
AchumiBokali	AchumiBokali
AlAhliNCB_Care	AlAhliNCBCare
Azxd	أحمد
mohamad_shwkat	MohamadYahyaShwkat
DrFaiza	Dr.fmf
tudily	Turki
Nooura_	Nooura
MidoAlarini	Mido El-Arini 💜
GLAM_SANAD	قلم سند 🖋
AmberBufkin	Amber Bufkin
DoniiaSamyy	Doniia
ZahraaAli	Zahraa Ali
SAMA_BADR_	SAM'SOM🦋.
MidoAlarini	Mido El-Arini 💜
MashaelALRouqi	Mashael
idresskhan	Idress Khan
asdfagr	Asdfagr
FathiyaAlsaddi	FATHIYA ALSADDI
Ben_Al_Sahem	بن-سحم 
ibraheim	إبراهيم.
KunNofi	Nofi
Kltamalanatl	Khitam alanati
FarahAhmed	Farah Ahmed
demtriailove	Demi Lovato
DaIaL_	Dalal 🇸🇦
Omabooo	Omaboood
Dona	Dona
ladyfatend	فاتن faten
TggAhrdg	الهدهد
fhdx	Fa
imad_ahmed	IMAD Ahmed
nn_	ن ن
Slm	SA💛
lielouan	Lie
Taif	Taif
Amani_	أماني'
Omar	Omar
DHoooMz	DEEM.🎖
LupaneStation	Lupane Station
Safiahi	صفيه
alxanzr	Alxandr 𓋖
SamSad	Sam Sad
DarkNour	Dark Nour
ABDOALLHMOHAME	ABDOALLH MOHAMED
hmidimounir	Hmidi Mounir
NourhanBassem	Nourhan Bassem
angela_berri	Angela Berri
TeamLeoGo	Team Leo Go
Abo_sa_ad	Abosaad
NadaElemary	Nada Elemary
AlBattar	البتار 
fatimahdr	| Fatima | ☫
majjood	majoOd ~
FathiyaAlsaddi	FATHIYA ALSADDI
GamelGamal	Gamel Gamal
rehabel_sheikh	Rehab El_sheikh
remmaa	Rema
AlBattar	البتار 
hmanii	حمني
Fas_MeB	Fãs MeB
litttlemila	Mila
Tt	Tt
Abo_fiesal	أبــو فيصل
MAboghareb	Mohamed
MennaRamadan	Manona 💖
melissadiaz	Melissa
Tt	Tt
mhdghriri	Mohammed
ASaadi	احمد
namoradadenerd	Namorada
Elmasry	MoSd
Elmasry	MoSd
i_NeeF	نيف
_missunique	Miss Unique
majed	𝑀.ماجد
sUlTaN	Sultan
KamiliaMowafy	Kamilia Mowafy
midasv	ميداس
Ali	Ali
iuxxx_	Als ..
jamal_malallah	جمال مال ﺍﻟﻠﻪ
MianRauf	Mian Rauf
aqsana	Aqsana
KimDavi	Kim Davis
AhmedElhassan	Ahmed El Hassan 🦍
alnahoarabi	النحو العربي
OmKhale	Om Khaled
PT_Hadi	Hadi
majed	𝑀.ماجد
samarb	Samar 💛💚
jooorre	جوريه 🕊🎻
fxnewstodayAE	FxNewsToday.ae
hamadsalemnaser	حمد سالم ناصر
Sexawy	Sexawy
Nora	Nora
Huda_arfaj	Huda Abdullah
abortal	ابومشعل
NadaNas	Nada Nasr
Saati_	Saati
alahmd	AL,hmada
IdeiasVestidas	Ideias Vestidas
mohd_hudaib	﮼أبوهديب
memem	مريم
alraoujitame	Alraoujitamer
Watan	Watan
Benz	Benz
moath_	معاذ
sajadh	سجاد
alanoud_	العـنـود🦋
Eyad	Eyad
FUADALABADI	FUAD AL ABADI
GR_SHOTO	S H O T O🕷⁸
adnullah	عبدالله
FathiyaAlsaddi	FATHIYA ALSADDI
Imajedi	Majed
sajadh	سجاد
Mahaahli	Maha_ahli
mohammedala	Mohammed
SofeYassin	Soof Yassini
Fhl	Fhl
behindzascene	Behind بالعربي
remmaa	Rema
Doooodd	Doooodd
remmaa	Rema
FathiyaAlsaddi	FATHIYA ALSADDI
albtl	البتول
Hepa___	Hepa
MAHMOUD	العاقل
Dona	Dona
Smail	Smail
hmms	همس
bosyharb	Bosyharb
hamadsalemnaser	حمد سالم ناصر
Crimina	Criminal
SalimSalemt	سالم
Amonchika	Amonchika
EsraaElhawary	Esraa Elhawary
lasam_	Layan💜
DqSwJXVQssVG	سعودي مخلص
MH_	MH
DefHarbi	Def🖤.
AmrSala	Amr Salama
Talal_alharmali	طلال الحرملي
OfficialHosam	🏹🇦🇹Hosam
jkore_q	جـكـوري -
Tareq	Tareq
NASSERxi	NASSER 🎃
UserRaghad	RAGHAD
Manar	Manar
watenalqalb	وتين القلب🤍
saleem	SaLeeM
Maha	Maha✨🔮
DqSwJXVQssVG	سعودي مخلص
mishmosh	Michael
baghdad_	﮼بغداد
samr_alareefe	سمر العريفي
yazeedalbusidi	م. يزيد البوسعيدي
JEEDO_	مجيد
Miie	M.
KhSuleimanAziz	Kh. Suleiman Aziz
Hanz	Hanz
faisal	فيصل
AlAhliNCB_Care	AlAhliNCBCare
faisal	فيصل
te_xr	روز.
jinan	جنان
yamr	Yamr
IBasim	باسم
AbomohabRaslan	Ahmed Raslan
KimDorris	Kim +
AbeerF	Abeer
IAZ	عزيز
lliiss	لمى
megoelhamy	Mego Mego
AndreaG	Andrea +
Ammkalfl	الفحل
Safaa_alOom	صفاء 🇯🇴
siuii	ساره
Analfadli	A_aljnobi+
Albarjasi	ابو برجس
ifarah	فـرح
SaminaK	Samina Khan
mahdyalghazal	مهدي الغزال
DodoMoh	Dodo Mohamed
Ben_Al_Sahem	بن-سحم 
mlk_oun	ملَك.
HamsKandel	Hams Kandil
KBamboog	بامبوو
tarekelgeidy	Tarek elgeidy
M_almo	اميره ~
AmyWebb	Amy +
Madlen	مادلين
Amjd_	Amjd
siniorass	SIN♈️
sqvn	Sara
bandaralhrbi	بندر الحربي 🇸🇦
iihatoon_	هَتون
MTairqKhan	M Tairq Khan
UmUrubah	ام عروبه
Tahalowi	طه لؤي
M	M
Rt	Rt
Khaldooooon	Khaldooooon
Turk_i	Turki
boooonasar	بو نصر
HindAbduaziz	هند عبد العزيز
berdnajd	☆طير نجد
Nayrahani	Naira Hany
Omar_Wael_	Omar Wael ✨
Looole	Loole
MuhameedHussai	Muhameed Hussain
_iwb	iwbG
thekin	ملكي
IMxvjWCUAUsQf	بوجراح
basma_saif	بسمة سيف➰
Sindrilla	Sindrilla
wteen_alshehri	وتين الشهري .
mohammedl	محمد
Zaidzaid	Zaidzaid
ndBpTMgcyjDxP	بنت الجبل
Khalil_Alshaeri	خليل الشاعري
Ivan_	Ivan
nwafallfaredi	نواف الفريدى
naserteacher	ناصر عباس
jood___	جود
almourgi	الروقي..
xrar_m	زمهرير
Noojah	Noojah
ElDod____dod	El Dod
iirujr	ناصر
Sam_Samia	السمو
romantic_lady_	Majestic lady💙
ssssssql	سِقم
lamiiaea	Lamia.
narain	نارين
saadabokhalid	سعد بن ثاير
ssssssql	سِقم
Theprimeminist	The prime minister
alwalid	الماس
KzzO_	Skz.
a_sl	عادل
DanaAlabdely	دانه العبدلي
saz_x	سيدرا
ssssssql	سِقم
ssssssql	سِقم
Smai	سما 🇸🇦
Huda_arfaj	Huda Abdullah
sultan_iu	سلطان
SOS	SOS
almaleekaah	👑الملكة👑
ofo__	أفُــق
jojosaad	الجوهرة
Gorgeousold_	Gorgeous Old
Foom_	Foom
phOmarMohammed	Ph.OmarMohammed
sultanhn_	سلطانه
RamaAltibi	Rama Alotiby
Imadbashbash	Imadbashbash
Bailasano	Bailasan
ELOMDA_	العمده
hh	Hh
karimHamdy_	karim Hamdy
Husham	Husham
sheroukelbanna	Sheroukelbanna
walesd	وليد
TAMIMI_	‏ AL-TAMIMI
_AhmedDhidah	Tired bro
walesd	وليد
FathiyaAlsaddi	FATHIYA ALSADDI
B_Almas	بُشرىٰ 🕊
Foz	Foz
