reiu 	零
eryu	耳語
bbb	無名
add	呂歐滴
wanwan	晚
yume 	宇夢
s	空
wangseng	王胜
Ggggggggc	海哥
bailiusu	白流苏
ss	阿明
B	森
yayiaiaiai	牙医爱爱
t	神風
Li Ying 	李颖
sir	荣
Ale	爱乐
ccoo	艾跟風
z	洺齊許
tt	肥
yah	弐
nice	踢
Show	嗯
Vince	灵
A	庫特
siaofu	曉芙
Lau	文誠
tommy	木一
Rwii	阿隕
Wang Pu	王攵
reiu 	零
sky	阿布
ne	七
dog	凱恩
mollypooh	維尼汝
diay	夢蝶
Owiec	夜
Tin	米粒
y	洛
sisiya	丝丝
sisiya	丝丝
dld	嘟嚕
keke	可可
Sally	路喜
keke	可可
Sally	路喜
Elian	无意
guwen	顾问
mmoogg	母
 mmeng	萌萌
tatami	塔塔米
tatami	塔塔米
wuyong	无用
ningying	宁盈
suibing	碎冰
Ggggggggc	海哥
mollypooh	維尼汝
malasongf	马拉松
aisisiya	爱斯
ljjy	梁軍
Chao	啊
z	牛島
Mu Mu 	喵姆
dzjsqy	紫諾
reiu 	零
 iyumeko	安和梦子
eryu	耳語
f RM QSgo Ov	穆兆洋
Ninja Zyd	阿瓜我爱你
Kinky Horny SM	春小叔
Xiaomeng mimi	不會聊天萌
O Ffuty UU Rv	青梅灰鷹
V TD Qs Xem RB NTr G	亚博体育课呆呆
douyin H	抖音
maobaoxiaoshuai	小帅猫
Mhig Wakne DZyk	龙阳帝君
ti QN Gb NE IHc Ix	胡桃夹子
wangdavid	猛火龍
yangyifan fan	凡凡
Lushanzilong	庐山紫龙
shuiqiuhan	水秋寒
nanao k	君見春
chenlive	陈彬彬
jiashidu	贾世度
rkz BItbcvvvu P	淫荡娇妻
Lushanzilong	庐山紫龙
hirokimi	次郎
nagaikei	澈
little angel	小天使
Chingtian	晴天
z Zcf QHkhd OF Kl	古灵精怪
 yikiyomi	萝莉酱
S BS Rikrrboo QP W	搂住搂住
 yikiyomi	萝莉酱
wanwan	晚
linjumming	麟峻銘
xiaoxingbrother	一根稻草
wolfgangchuang	台南小次郎
kmz Nq FX Pa AH	龙口西的王
Double Fake Cute	多戲超人
huangxiaohao	勇者的木棒
balibalihon	黑匣子
likeilei	怠惰猫
G FWfrog	墙国蛙蛤蛤
Zenopoch	横流
Tiaoi T	啼啼
Jayson	森骏
h BRnxyr LT D	宇宙神偷给爷爬
Aimer Ssan	萌阿珊珊
I IU MPs Gmt ZT B	突破寂寞的哥都月
yume 	宇夢
tianchaolangren	楼凤浪人
Huang Fuping	皇甫平
Peterlongny	牛逼兄
ywrito	齐季
ika  kichi	魷吉吉
x Ch Jy JFwv KV Hv	辣椒炒咖啡
jil RL Zk Spgf O	举小白旗
Xof QUm Uvz GK Tf	如果你也愛我
Radiant HK	池沼
doooiny	杜恩
chinanewsbot	中国新闻
Jtko Az JI Oujl B	不时常的日常
notesnword 	類三麗鷗的盤子
wangseng	王胜
solafuxiao	拂晓
sumiko aymy	王茉莉
kosenaoki china	古瀬直輝的應援帳號
dangsangwangbo	宕桑旺波
y AQ QNk Zm YQxn	逢卿先生
daijiali	欲互私
Eppj ffjh	咚东
P RW Mry VEv Jut IH	希望没烦恼
j VDzzuvfgc FH	长沙小包子
shangxiaqixin	上下齊心
xuechaigeng	柴梗
gxe ZN Jr XI UJ	农民兄弟
govievpjst	猪猪
D XH HK A	小花花
shikatanori	王磊
govievpjst	猪猪
chair	龍騰井
xif Qyl Et Bvw	豐原狼不差
Aak Za Ou Dv Wu P	我要吃奶
justin	复活号
justin	复活号
edwarde	仕麟
huruyunfeng	虎入云峰
B Better	斯蒂文
govievpjst	猪猪
Bfwj LD Ckpuo	林子明
mys tx	苗子猫
fupingpiaobo	小狐狸不熬夜
B Better	斯蒂文
G MPing Lun Y	公民评论员
Shino	小泽
fupingpiaobo	小狐狸不熬夜
fox nc	雄浑
linjumming	麟峻銘
aisha huang	羽凰
bailiusu	白流苏
jy Kekj Fi W	泰拳刚猛
T Bol Ty AUiokc P	收正装中年
A YX AAl Na Je	碧海潮生
Zrt Ax FN PMp L	宁波主收奴
Moi Suet	马来大妈
setlivenews	三立新聞
Raymond O RD ER	蒋少卿互
G Vsm Dw LXe	一只白羊
xiaotaojiang	小桃酱
hpgq YKa Sqa HJ	苏凯佳
zhuzhuchuanmen	珠珠串门
niushiba	牛十八
Fengsiyuan	死因
Hnlinayi	琳姨太
doudoudewou	小兜兜
abcdelittle	小小葛
Z S Piper	薄荷棠
Yd Qie HA TY Fj QU	医院快递
waterbaby	你的水寶貝
Liu Xiang Yong	劉祥永
Taxuewuhen	踏雪无痕
muzhige	木子哥
Jigme Pema	劲美白马
Daily China News	中文新闻
m ZG Cw Celjj Sg	种花家的小船
xinzhaoyiseng	欢喜密探
wamei	袜妹妹
hu lalalalala	出埃及记
yayiaiaiai	牙医爱爱
iyo miyon	伊豫乃
Her Bai	张旭
sexsusususu	苏苏学姐
Cq Gy NG Nl Us Xn G	力拔山兮气盖世
Annastasia 	阿娜斯塔西娅
nv Ys UHo YBfo Ev	光明恬淡
Ec QR VT OE Ln Aj B	刘成龙
tangguolili	糖果粒互推
bilidilimi	哔哩滴哩咪
taishiandlovu	扑神史少
  Linsen  	吸酚丨発生
wamei	袜妹妹
Dr Wf YU Adoro	杨怀斌
huangfandong	黄反动
uc DJfayc LKu	大宪章
Ehkwe Srcg W	夏天的风
J J	深圳姐
Tsukishima zero	優花花花花
liangqinga	厨娘
heizemeiko	黑沢美空
Zh IO UPti Bkz FB	傲血小松哥
caikun	星落
Corning Tucke	看圖用
beimeiduoshou	美国剁手
Anati Amir	小琴
z Zcf QHkhd OF Kl	古灵精怪
n KM Ou Sn Bsuen D	魁鸿钧
hda EWmyu Pjs Q	塞纳河边的渡鸦
hda EWmyu Pjs Q	塞纳河边的渡鸦
xiaoniaojiangyo	探花系列持续更新
shrink Sean	王时敏
tanggulashanzei	唐古拉山贼
irvinedai	深潭
Huiye furry	辉叶
Croro Kie	好耶
ccpviruskl	正道
lijuxia	猫本猫
Li Ying 	李颖
zhuxiuliang	朱修亮
Hnlinayi	琳姨太
wrygyuitlalvunr	一针见血
xingyinxiaosao M	夹你大鸡鸡
luoyanghanzi	牡丹花下
ghtandyy	网神
j Ppcq SJr Wha Y	君见见
justin	复活号
shangxiaqixin	上下齊心
yeyuan	风行
gaiboyang	改你妹
zhuanyan	转眼
im YU Lbxmw KX Nd	久保俊明
dedydedy	灵唯
luoxiaohei cat	罗小黑是猫咪
kingliu	刘
nkimo	壞老爺
Jinjiumaon	津久茂
B Oi Llpkh UJb CH N	水里的猫
C HX IA	迟夏
Z J	同学
f Nzel Lo Rt UFy G	小灰灰
Zccm Qr Yu RS	马克
Chinese X U	君子中庸
shosx  	三二八
sir	荣
Dao Gao	黑黑
Darkrain	暗雨
G XKmme Ut Ph LUc	机器猫的口袋
B Bbird	爱吃和
liuwenjay	劉文傑
rxin	山河
Y ZKa Fown SAqmf	我自己
k Vktpf Wx Pe	周泽
xiaoxiaoyu	小小雨
kungjimbo	肖丸子
Twt Video Of China	推特影音中国
fupingpiaobo	小狐狸不熬夜
N HW Ioyge NEcgl B	跟随教练
Ls Zoe	石木刘
Z MG H	走馬觀花
Ze Xbn DL Jvg Zh	林骏杰
qingdao	青岛
daweijueye	伟爵爷
Iam Yang Guniang	杨媖媛
Ilovehostage	斜陽紫陽花
longyang jun	龙阳君
M UY I	木亦
u CI EC Mubeb Xv	胖胖胖先生
qingdao	青岛
hotteokk 	糖餅
Yg SXfl ZMpg N	稀里糊涂迷迷糊糊
yuelaozaixian	月老妹妹
hymall	马卓
C HX IA	迟夏
chenkunnan	原始人
Q LC Kg Mlxj HS N	都不睡觉在看
kembaliannongfu	羊驼崽
u Vx Fv Vzjwng M	大哥大嫂过年好
real Lowpayman	低給料青年
usagiai yani	愛香坂田家
heizemeiko	黑沢美空
hymall	马卓
qzj CJvyo GR Kw	不摇碧莲
kosenaoki china	古瀬直輝的應援帳號
yah	弐
U Bk Pt FC Xy Vv	到处撒野
Darkdivebombe	爆撃機
Judy And	茱迪
X II ED BLqyo JS	你幸福吗我信了你的邪
t POm Yb Drsy OWf	张蚂蚁重飞
Wy UC KIm Rw Dyl Wb C	畅快了吗
yeyemiao 	夜夜教主
D CAtomy	台灣寶島農場
zaijian	小王老师
shanchahuahua	山茶花花
wanjunxie	谢万军
T OP TO PS SS TO P	暴力打桩机互推
Baitaocha	白桃茶
guozudong	小郭
a Wenxiansheng	文先生
    Paimon	魈派蒙
Inayet	伊纳耶提
Xi Jinping C CN	习近平
namesaker	广佛深
garagedoorguy	真相难觅
Hnlinayi	琳姨太
lingkongmanbu	临空漫步
Charles Lui	鄰居人妻
a Wenxiansheng	文先生
g QC XGqu VG Odor	野爹李灬博
nekopimeow	猫大皮
Melisa Ou O	香菇
Eli Smallnice	廖恩孝
i Bt RZc EE Ul	急如风火
Daily China News	中文新闻
peggyrina	喵
wacxl	依酱
memoryshion	目盛詩園
Eru Xi	醒醒
mianxiangfashi	面相命理法师
Bluesty	已婚雙寶爸
f GD JYo ME V	重口淫俠
skylar	老鱼
yeyemiao 	夜夜教主
Bluesty	已婚雙寶爸
zifeiyu 	子非鱼
taozijiang 	桃姊
K Jd QIpry PT SL P	六年級的大叔
  Linsen  	吸酚丨発生
wangdisheng	王富贵
C Apo	裏垢
hpgq YKa Sqa HJ	苏凯佳
Lu Jf VXskyepmg Dn	璀璨的街景
Eleven	張煜雯
N TD Chinese	新唐人電視台
mitsune miyagi	宮城弥恒
Lin Tao V	一只阿斌
yuzetao	涛
 Jiayilim 	吴家宜
Rabbiteat	互推
pa XG KR Dk GKkf P	起了隆冬强
siaofu	曉芙
luremy 	蓝石
wen   jincong	聪聪
Han Ling Wu	吳翰霖
sspreadmywingss	這是塔扣
xif Qyl Et Bvw	豐原狼不差
Y Ydexiaogege	倾心明月
shuiqiuhan	水秋寒
asr rg	牛黄
shiziwang	狮子王
tommy	木一
u Bqyl RBd Tog R	幼幼资源
Coco	麻辣火鍋
Song Ci Gen Trad	宋詞生成器
Song Ci Generator	宋词生成器
baiyemijia	百夜米迦尔
Kakaluoter	乔巴
G GZ ME Kov ZJ	老朱珍言
Wang Pu	王攵
Ke Zhang	珂珂
Pisces Love	高手來了
cwoflk DR NX	夜风吹过
hf Loa EOz Tli Om	糖枫树的枫糖
Tanxinbuzu	貪心不足
longlongmima	龙龙
reiu 	零
Dm GVdqn Jw UFakd	木木木木木呀
minghaiyijiaren	明海一家人
Bu Kg Ncfir HLdo	大大泡泡糖
Rinko Arazome	白花幽鬼
danbaijiang	蛋白酱
C Koszs	路易吉
zoepiglet	肉肉
Moonight to sky	夜月飞雪
n Za Akq Eyv Io	鄰家男孩彥欣
F F	枫枫
fatmeloveme	刺蝟
tigertail NF SC	老虎尾巴
E TA Lwhaing	惠林
wb VQ Jd OGu UMgg	龙建飞
q TH Hppwgs DG O	想你的互推
dog	凱恩
milpitas	郭宝胜
O GT SXhe ME KL L	道斎先生
K Rbz Ub Ai Jp Lz	贵州茅台批发
mollypooh	維尼汝
A Q yukky	管理人
diay	夢蝶
hirokimi	次郎
 Xiao Long Nu	小龍女
luremy 	蓝石
Miaomi Video	小喵咪互推
Ming Jing News	明鏡新聞網
Jinjiumaon	津久茂
 Xiao Long Nu	小龍女
asashi Izumi T W	泉很喜歡烤櫛瓜
K UI  Y AN G	葵阳先生
moonicelin	寒月凌
rxin	山河
r Dct	沈曼
N TD Chinese	新唐人電視台
sehuatang	色花堂
fengqingyang	申公豹
justzaizai	开开
aituno sabu	流山森
zhangxiaofan	张小凡
y	洛
fengqingyang	申公豹
fuckgaijin	滅惑星民氏
chichu x	彳亍
sisiya	丝丝
ffan fu	符帆帆
miniqiu	互推
c CM BHve Fa G	孔雀开屏
sisiya	丝丝
Hgvj BQ We Xb Uu Si	就溜达了也不违法
ninidainiquwan	妮妮和你一起玩
Lavunia Laspe	糕理治療師
Lushanzilong	庐山紫龙
kexier	可熙
L CC CW	勃弯
H Z	张
I Mtxw Be Pnfb	死胖子
zhishengji	直升机
Zeiss CLacklein	安提鸽涅
Nljns KOz E	爱肉丝袜
lixiaoxiao	李筱箫
hk DW Wy GDd G	城下之盟
keke	可可
xiaoyingla	小樱啦
damien zhikai	消遣
luo mingming	罗罗
xiaoyingla	小樱啦
Sally	路喜
C Timee	千时
keke	可可
b BA Dzw Ia EFpqh Au	秋风扫落叶
Sally	路喜
balibalihon	黑匣子
ttgdlexiaoyao	姚國山
M IN GY OY OH	翡翠人生
Nchaosww	钱锟
lisa misakanon	好想養貓貓嗚嗚
Two Zhi	兔纸
edison gao	爱迪生高
pingguojiang	平果酱
Daily China News	中文新闻
fn WE PWlt Eeuyk	岁的小骚货
yeissactessa	正念
callmeshawn  	尚恩
evilkmsw	恶魔
Pai Guat	排骨
xutongtong	互关
g OL LO NAbvx SJ	行走的骚货
f RH SPhxt Evlg R	大秦铁骑
czxzhuoxuan	陈卓璇
H IK Hcheat	高雄不差
xucong	聪
spicy zasasa	夏莎莎
O Yi PXub DBs Wo AP	我的小执着
pm SJ MHbuhs KH	齐鲁懂王
robberyasd	溫精彩
ko Sb XL Sg EUjrq	隔岸观火
Tf Nyu FRpy RF	川建国
chenhui	小表弟
Smzj Q	山姆大叔
Elian	无意
youuumi	小优米
Htqf RK JP Qb ZT R	兲请嫑昊
ug Fpbn Yf Lvk MI	魔都后情侣
jyd Wo SZ Owk Oa P	甜心丫头
T T	李冰冰
wangganghao	胖子
Ge Lu Lily	綠竹新梢
B Pj SQ El Pp Yw FS	曹三秒
xiaohuliyao	小狐狸妖
daihaomoumou	某某
Osaka Lucky	大地子
En VAxy Flj EU A	性瘾先生
wangdavid	猛火龍
Li Xiao Lang 	狼三岁
molly haru	莓莓
chan leo	田三七
freemanparadise	唐风宋雨
sydneydahai	海湾
auoaljee	董欣妍
zdylovezyxsb	猪宇轩
govievpjst	猪猪
betaray	放空
ritatabk	红参冻咖啡
jujube	隨風起舞
kirito	習禁評
f Gf Gs Jp QE WYk T	南派派派派啊
Ch Mayumin	繭眠新人
Chen Min Feng	晨夕
Y Akifuyu	闲人闲语
Leechen	向雲棲
Nuq Gk Qx Ieoh	林志隆
Jingsalover	景飒
beiyudieying	寂寞先生
crbo AJ NV Ll Kh	大河蜿蜒
ew Lr IJu Cuk Pm	索隆君
Yaccct lwk	娅娅
k Jw Ay NVi Ymaq S	乐鱼体育
Gtluoli 	狗头萝莉
kknowwknoww	谢兴阳
edmond roxanne	兰花炖
kanzhongguo	看中國
Anna Cutts	砍师
ohyaoutdoorstw	鄰家大叔
y Nw Qd Pqft Dhi	王可可
wplnc	天
guwen	顾问
steven ldy	粽子
xiaowanzi	小丸子
fupingpiaobo	小狐狸不熬夜
mmoogg	母
 mmeng	萌萌
Ai Ddenlk	南久
Wesson Lee 	李维绅
N TD Chinese	新唐人電視台
N HW Ioyge NEcgl B	跟随教练
kwongwah	光华网
Edd BV GX Wi Er	追风少年
eeeeeasy jyanai	我恨期中
tatami	塔塔米
Hovo QNw Up AIm Rts	是騷人也是墨客
Sandymomo	魔法小喇叭
wuliaoyueyuepao	无聊约约炮
chowkinwah	貓婆婆
Tiaoi T	啼啼
nanyangpress	南洋商报
pagedown	诺大
tatami	塔塔米
loshuwentroy	羅澍汶
Jnfrv Ch Uxa	喜熊的喵喵
P OT US bot	歴代合衆国大統領
Gi XO PEjjyg XV	小太陽
chaichaicaicai	柴柴可互推
Salsh Valkyrja 	特級廚師元歌
Alexander John D	大基基
Ae ZUt CBx PYv BR	新马美女约炮
chunshuitanggg	春水堂
daijiali	欲互私
Yao dali	啊帕卵德
Fj DG Ti MGiv Su	左丘无趣
wang 	王三一
mayanganglixiao	北山街
Asa Kar Yeh	瞪不荔多
f Kn PK Tcsfli VV	高速蜗牛
Z Veb Sw GE JWtn	彀外斟唱
iya kihyaka	北百川
peggyrina	喵
mingrisj	明日世界
Ji Pin Zhi Nan	极品直男
V Nc QM Im Eu Fk	失落的歲月
wuyong	无用
ttokbokijowa	喜歡炒年糕
 panmin	圖蘭朵露
ttokbokijowa	喜歡炒年糕
huanguhu	黄
ikazo	毛毛
toushan Bai	白头山
toushan Bai	白头山
Zhenji	大洋彼岸
lena km	哩那
   eunn	貝果
ningying	宁盈
J XF	纪舷飞
seven orifices	半生熟烏龍茶
Taxuewuhen	踏雪无痕
syayofuwan	小肉饭
g DV OKxs AS ND Qs	最爱老婆口交
suibing	碎冰
 panmin	圖蘭朵露
Zhanzhanlover	战战
Iccchauuuuuu	发情
Croro Kie	好耶
Kumakichi Taro	熊吉太郎
Jnp	渣恩
canned pear	梨缶詰
tujitutu	德川家兔
ccpviruskl	正道
stripeboy	斑紋
chaichaiwanwan	台北野犬
leexxchen	李成
real Anthony Lee	老中医
i FB To JGv PI Of F	圆滚滚团子専用
g DV OKxs AS ND Qs	最爱老婆口交
Haku Go Yu	紅果雜垢
lci Tib NO FG GC Cj	九黎
liuzongta	唯爱大奶
tw mogeko bot	最喜歡女高中生的醬
H IK Hcheat	高雄不差
q Oy Dpr Zp VNb	知道采购部
vincent	文邕
mollypooh	維尼汝
D XH HK A	小花花
malasongf	马拉松
xiaopenghaopang	小彭不开心呜呜呜
vincent	文邕
Ah Sen	森哥
chuangyuer	床欲儿
toushan Bai	白头山
Mindy Fenno	亚博体育
Wei Jiang	姜伟
Anna Cutts	砍师
toushan Bai	白头山
Zi KDn LT UJqo Mezk	伪娘潼潼鸭
huaizhao	懷昭
madetianbing	要開學了
xlmsnow	李玫
Kuro Nek	黑先生
S IF Ee Iijpt Ex Pr	林逆入关
sumairu	上杉
b RPj GG Ybvlzf L	逆夏晴朗
aisisiya	爱斯
realhsiaoping	爱慕安格瑞
Wu Mei Niang	武媚娘
D Cz UAbw HE Kb L	小九
pumkingpump	林姓喵叔
perryhau	然烧
x Ch Jy JFwv KV Hv	辣椒炒咖啡
miracleyoung	佳人
tabako 	子
ljjy	梁軍
mcba RAjti NI	江泽民
zhanyilianmeng	战疫联盟
govievpjst	猪猪
chenbrother	陳俊卿
Nljns KOz E	爱肉丝袜
songshengyj	嵩生岳降
iphoto tw	點子秀
branloo	叮当
Sp MP Raczta To	李炫宗
iiam Jazz 	星空
u Anhfm Tsw VSl	严小强
Mt GGcfiyau M	明明如月
uraj Ea MO Tfbb	烟台公子
siyuefeixu	旁观者
qinggeng	晴耕
homegardenbjslc	小可爱收容所
Rkf Ge TOg JAm	钮祜禄栋栋
Kulas Leanne	爸爸我叫
xueshengyedie S	你学生野爹
Daily China News	中文新闻
Claire S	伊少女
Tt Feimaotui	飞猫腿
itxzrkc	开
Love Xuxi 	黄旭熙
N Kj LOz Xiaw Ou	春暖花开
N G Yue Ling	夜神月凌準備中
Y H	铁木尔
joomi	啾咪社
toushan Bai	白头山
F WVi SCkk Yu HS GTq	肖鸿庆
Nolf Anti CC P	无人永生
Mu Mu 	喵姆
Lin Jing bot	林静
 Mu Nian Ci	穆念慈
dabudong	大补洞
dzjsqy	紫諾
