tsudayan	つだやん
mashiroharu	ましろはる
mana	まな
nameneko	なめ猫
himuchi	ひむち
eite	エイテ
momose	百瀬
shibayan	しばやん
minakuma	みなくま
sakura	佐倉
ribon	リボン
fon	フォン
poyoko	ぽよこ
sakoko	さここ
na	ナ
mana	まな
eden	えでん
rendian	レンディアン
waru	わる
umiuma	うみうま
taka	たか
zuiro	ズィロ
aipon	あいぽん
hiyo	ひよ
sekai	セカイ
kyome	きょめ
yasumattechan	やすまってちゃん
oitan	おいたん
ri	り
hiname	雛芽
hiro	ひろ
takefumi	たけふみ
buronto	ブロント
kureha	くれは
poyota	ぽよた
hitomi	ひとみ
karaza	カラザ
nakachanman	なかちゃんマン
hoshinome	ホシノメ
kuroyuri	クロユリ
deaiwomotomete	出会いを求めて
kaneyanaoto	かねやなおと
sayako	さやこ
mikuto	みくと
kusa	草
nokko	のっこ
ahakuoku	アハクオク
pachi	ぱち
shiyu	しゆ
pannomimi	パンのミミ
menokumo	目ノ雲
zatsuzakana	ざつざかな
moguchi	もぐち
haniwa	はにわ
eguro	えぐろ
shironiji	白虹
ai	あい
kakeyoruaichi	駆け寄るアイチ
sakamichi	坂道
nuretaoru	濡れたおる
nerooren	ねろおれん
dandan	だんだん
sakuradori	さくらどり
otose	音瀬
hachi	はち
takiren	たきれん
hinaarare	雛あられ
kurashiro	倉城
reogiku	レオギク
ebi	エビ
ton	トン
kaze	風
yatoo	ヤトー
hiyori	ひより
nasa	なさ
maehoma	まえほま
kuroichi	くろいち
ka	か
taketori	竹鳥
erumisu	エルミス
bayashi	バヤシ
miyaneyafan	ミヤネ屋ファン
kawahira	カワヒラ
saya	サヤ
aki	あき
burita	ぶり太
sayona	さよな
tadanominami	タダノミナミ
aya	あや
yuyu	ゆゆ
sanzouhoushi	三蔵法師
taruto	たると
makimune	マキムネ
yumenami	ゆめなみ
shirona	シロナ
nonono	ののの
yukito	雪徒
koinobori	こいのぼり
suzuri	硯
run	るん
hakkan	ハッカン
sayako	さやこ
yawarakan	やわらかん
haru	ハル
nohohon	のほほん
okakuro	おかくろ
hisui	翡翠
ringo	りんご
kinopi	きのぴ
main	マイン
chiipapa	チーパパ
rui	ルヰ
omina	おみな
kopi	こぴ
rina	りな
ronfan	ロンファン
iyosetoka	伊予せとか
tokoton	トコトン
piyoko	ぴよこ
osarunosu	おさるのす
boyakenasu	ボヤケナス
mirai	未来
takayuki	たかゆき
tsubaki	ツバキ
airin	あいりん
yuri	ゆり
yuno	ゆの
koko	ここ
tomo	とも
shigu	シグ
omarisan	おまりさん
maguro	まぐろ
anmochizouni	餡もち雑煮
warabi	わらび
ayapero	あやぺろ
yata	ヤタ
nintentou	任天党
suzuki	すずき
punzatsu	ぷん雑
yuni	ゆに
runjirou	るんじろう
marina	まりな
maorosu	まおろす
usushio	うす塩
adoria	アドリア
arare	あられ
rurisa	瑠璃沙
nun	ぬん
yokochanhonpo	よこちゃんほんぽ
maguro	まぐろ
ere	エレ
ringoame	りんごあめ
non	のん
kokui	こくい
rina	りな
shigewo	しげを
haku	ハク
chiyume	ちゆめ
hanku	はんく
gegegenomosuke	ゲゲゲのもすけ
noinoi	のいのい
kirierenko	きりえれんこ
panda	ぱんだ
maaya	まあや
kumine	くみね
sobana	そばな
sannana	さんなな
behemotto	ベヘモット
buran	ぶらん
sumiso	すみそ
kirinoorehana	霧野俺はな
matsuri	まつり
shigechan	シゲちゃん
mogu	モグ
sakeonigiri	さけおにぎり
hiyoko	ひよこ
miu	ミウ
nao	ナオ
tougeno	峠野
yoga	よが
kaede	かえで
niboshi	にぼし
ria	りあ
renbou	れんぼう
hiyori	ひより
onteion	オンテイオン
yamada	山田
arare	あられ
kareepan	カレーパン
soramame	そらまめ
nna	んな
hisa	ひさ
mei	めい
satou	さとう
konnyakuu	こんにゃくぅ
kaiton	かいとん
ame	あめ
kurose	黒瀬
ramuko	らむこ
uzumakinene	渦巻ねね
ruina	るいな
anmochizouni	餡もち雑煮
kazuki	かずき
yagami	八神
yaku	やく
yoda	よだ
macha	まちゃ
maru	まる
nidosuke	にどすけ
sakanamori	魚森
purioji	プリおじ
saburin	サブリン
yumi	ゆみ
kinuho	絹保
jusui	入水
tsuchitsuchi	つちつち
mono	もの
komachi	こまち
anmochizouni	餡もち雑煮
muchimaru	ムチ丸
natsumin	なつみん
oubi	おうび
zakkyun	ざっきゅん
bebi	べび
hazama	ハザマ
hiyamugi	冷や麦
sunato	すなと
marokun	まろ君
okametsumamiya	おかめつまみ屋
tomo	とも
umibouzu	海坊主
kohaku	琥珀
masayoshi	マサヨシ
taima	大麻
guratangou	グラタン号
marupo	まるぽ
nomizu	のみず
yaku	やく
runa	るな
emabu	えまぶ
ponue	ぽぬぇ
kanata	かなた
sakananomon	魚の門
rukibe	ルキベ
usamemasanobu	卯鮫正信
sasurai	さすらい
watagumo	わたぐも
nobuakira	のぶあきら
ayayan	あややん
higashikata	ヒガシカタ
aki	あき
kuzuokiba	くず置き場
yawatako	やわたこ
mao	まお
rizume	りずめ
edakichi	枝吉
renamaru	れなまる
ameusagi	雨うさぎ
yuha	ゆは
tanishi	ﾀﾆｼ
kikusan	きくさん
karinosuke	カリノスケ
kanata	かなた
hideki	ひでき
sato	さと
akikaze	秋風
makoto	まこと
kensuou	けんすおう
reo	レオ
kajiki	カジキ
makai	マカイ
yuusan	ゆうさん
suzushi	すずし
sakura	サクラ
itatsu	いたつ
nemoren	ネモレン
hokahokamanjuu	ほかほかまんじゅう
ranmaru	蘭丸
konekochan	子猫ちゃん
yuru	ゆる
nowa	ノワ
machintamu	まちんたむ
yayuyo	やゆよ
yamachan	やまちゃん
fukenkou	不健康
furuido	ふるいど
yakumo	八雲
tomochi	ともち
yuzu	ゆず
hisui	ひすい
migozuku	みごずく
juju	呪呪
zura	ヅラ
orusuta	おるすた
fuiriifu	フイリイフ
shinosuke	しのすけ
mikuteku	みくてく
tomozu	ともず
nagomi	なごみ
isao	いさお
matsuko	まつ子
nikuo	にくお
yuzukichi	ユズきち
wase	早生
kurowa	くろわ
denomotan	電おもたん
maru	まる
mizuno	水野
daizu	だいず
hitomiiko	ひとみいこ
yukineko	雪ねこ
aru	ある
takana	たかな
nakken	なっけん
chihomi	ちほみ
nie	にぇ
sakura	サクラ
yakumi	やくみ
minisere	みにせれ
aoharu	アオハル
yukimushi	ゆきむし
raputoru	ラプトル
pehede	ぺへで
yatogami	やとがみ
rukichi	ルキチ
pan	ぱん
purikun	ぷりくん
munpapi	むんぱぴ
ikumi	いくみ
shino	しの
nasumoku	なすもく
mana	まな
dozounonyaka	土蔵のにゃか
konkou	こんこう
rin	りん
ran	らん
inori	いのり
yachui	やちゅい
usakokaeru	うさこカエル
yuusuke	ゆうすけ
hirota	廣田
sakiika	さきいか
nagi	なぎ
makaron	マカロン
noppe	のっぺ
kanakichi	かなきち
shitorera	シトレラ
dein	デイン
namappe	なまっぺ
maki	まき
imunomori	いむの森
okazora	おかぞら
asupara	アスパラ
kaju	かじゅ
mitsuo	みつお
mukkoro	むっころ
take	たけ
kazu	かず
michirushi	みちるし
hime	姫
npapapa	んぱぱぱ
erika	えりか
ittousei	一等星
kuroimegane	黒井眼鏡
kakinyako	かきにゃこ
niwasan	にわさん
ayami	あやみ
kapihami	カピハミ
donkyuusai	鈍九斎
pekorun	ペコるん
aika	藍架
sekidousai	赤道斎
zazaboon	ざざぼーん
kieiro	きえいろ
miyatake	ミヤタケ
yamori	ヤモリ
sakana	さかな
mito	みと
ryokucha	緑茶
uchimomoniku	うちもも肉
nanonanao	なのななお
aoi	葵
haruurara	ハルウララ
kesera	ケセラ
noazami	のあざみ
sugita	スギタ
moko	モコ
juri	樹里
konkaron	コンカロン
ayaha	綾葉
aruchan	あるちゃん
panme	ぱんめ
gizura	ギズラ
momodaisuki	もも大好き
nanaonao	ななおなお
danna	旦那
yatohana	ヤトハナ
yumemura	ゆめむら
yui	ゆい
mao	まお
santamama	サンタママ
yoshimizu	よしみず
narita	成田
toro	トロ
umi	うみ
seriha	芹葉
noshin	のしん
kasugasumomo	春日すもも
poyu	ぽゆ
yoshitaka	よしたか
hinaki	ひなき
yuzuki	ユズキ
kimidori	きみどり
ankou	あんこう
kanpan	かんぱん
mukkoro	むっころ
piroshi	ぴろし
miso	みそ
yuipyon	ゆいぴょん
kuzumo	クズモ
juju	じゅじゅ
nashiko	なし子
mihopapa	みほぱぱ
mao	まお
soranomameko	そらのまめこ
furemu	ふれむ
natsuisara	夏井さら
guhehechan	ぐへへちゃん
yayoi	弥生
ryuka	リュカ
nayuki	菜雪
ichino	いちの
asami	あさみ
mayu	ﾏﾕ
tsuginohihare	つぎのひはれ
fukapyon	ふかぴょん
danmaru	ダン丸
renon	れのん
yuzu	柚子
ami	あみ
yukiyuna	ゆきゆな
niiwa	にいわ
otafuku	オタフク
sasa	ささ
sakuranbo	さくらんぼ
kojo	コジョ
yun	ゆん
ata	あた
pupipo	ぷぴぽ
inupyon	犬ぴょん
pandaman	パンダマン
hina	雛
micha	みちゃ
fuwafuwasan	ふわふわさん
takamaru	たかまる
samidaresensei	五月雨先生
yamiwa	やみわ
geba	ゲバ
asagiri	朝霧
shizu	しづ
yupiwo	ゆぴを
kagami	鏡
aki	アキ
sawa	サヮ
shiratama	しらたま
zono	ゾノ
bei	べい
sora	そら
takamarusuisan	たか丸水産
dorukuma	どるくま
mio	みお
mameta	豆太
masapou	まさぽぅ
kojika	こじか
airi	あいり
furifurimomo	フリフリモモ
yokubarisu	ヨクバリス
saki	さき
kozue	こずえ
nohito	のひと
akaneko	あかねこ
suzukaken	スズカケン
shigao	しがお
kaze	風
tanayuki	たなゆき
shizuru	しずる
yumemakura	夢まくら
riri	りり
azumine	あずみね
haineko	灰猫
kaguhakobi	家具運び
shunta	駿太
gizura	ギズラ
kakko	かっこ
amakusa	あまくさ
shio	しお
nimono	にもの
ramu	ラム
shitami	したみ
suzaku	スザク
kimayun	きまゆん
fuyuyu	ふゆゆ
satori	さとり
kino	きの
daiki	だいき
onekun	おねくん
otoko	おと子
saba	さば
sakusaku	さくさく
kurokome	黒米
muumi	むぅみ
amin	あみん
yasosuke	やそすけ
yoshikawa	ヨシカワ
kamikitakomari	かみきたこまり
anpan	あんぱん
dokkesu	ドッケス
shigure	しぐれ
yukikaze	ゆきかぜ
ari	あり
guraburu	ぐらぶる
kaede	かえで
rokka	ろっか
meu	めう
haibikun	ハイビ君
tamamizu	玉水
fushiko	ふしこ
yuumi	ゆうみ
rio	りお
haa	はー
pyoko	ぴょこ
kiina	キイナ
kyon	きょん
mahama	まはま
takahashinameko	高橋なめ子
nano	なの
metappou	メタッポウ
reito	玲斗
onikure	おにくれ
hiyori	日和
heki	碧
shigure	時雨
edamame	エダマメ
miyukin	みゆきん
pengin	ぺんぎん
kozakku	コザック
daimaru	だいまる
choko	チョコ
aina	あいな
hiyoko	ひよこ
rio	りお
sana	さな
kotobuki	ことぶき
yamashiro	山城
kanakeke	かなけけ
umeko	うめこ
shinohara	しのはら
aabakadana	ああバカだな
ejirin	えじりん
hiron	ひろん
shijimi	しじみ
sumomo	スモモ
washimi	鷲見
mamazame	ままざめ
nika	にか
aimi	あいみ
remi	れみ
taru	たる
murasaki	むらさき
hibikiai	ひびき藍
youshikibi	様式美
mugyugyu	むぎゅぎゅ
ukogi	うこぎ
makichi	まきち
masakishinya	正木慎也
usagisan	兎さん
komyu	こみゅ
maikun	マイ君
orurai	おるらい
kano	かの
chibiusachan	チビうさちゃん
haren	ハレン
hitochi	ひとち
tatsuya	たつや
miku	みく
nozepoyo	のぜぽよ
hiyori	日和
hisa	ひさ
takutakue	たくたくえ
vorira	ゔぉりら
aiueo	あいうえお
umu	う無
dakkoara	だっこあら
begaroka	べがろか
yume	ユメ
manamonano	まなもなの
ajisai	あじさい
furuido	ふるいど
raratan	ららたん
momo	もも
au	あぅ
memochan	めもちゃん
noa	のあ
ima	いま
masaya	まさや
kantaro	かんたろ
toi	とい
bayashi	バヤシ
mongorungo	もんごるんご
tatsumi	辰巳
guraemon	ぐらえもん
takaten	たかてん
arechi	あれち
murapen	ムラペン
kiku	菊
samechi	さめち
bansan	バンサン
nireki	楡木
akasaka	あかさか
matatabi	マタタビ
taiyaki	たい焼き
anko	あんこ
pinya	ぴにゃ
tanishi	ﾀﾆｼ
aki	アキ
ikuyumu	いくゆむ
gajumaru	ガジュマル
tebasaki	てばさき
yuki	ゆき
fukuchi	福地
murapen	ムラペン
towa	とわ
hiro	ヒロ
mineiyutaka	嶺井豊
rinna	凛那
nanona	なのな
damedamewanko	だめだめわんこ
ponzu	ぽんず
chika	知佳
kotatsuinu	こたつ犬
akuneno	あくねの
shiodoki	潮時
genmaitabeko	玄米たべこ
atsuka	あつか
akimin	あきみん
yahaku	やはく
ueeee	うええええ
ria	莉亜
izayoi	いざよい
pepechi	ぺぺち
sasamegu	ささメグ
sayu	さゆ
moe	もえ
chinako	ちなこ
warewaredan	我々団
urisan	うりさん
kosuzu	胡鈴
ryu	りゅ
nanriu	ナンリウ
reri	レリ
numauo	ぬまうお
chiisuke	ちーすけ
nijiokasan	虹岡さん
uraniwa	裏庭
suzuno	鈴野
sakura	さくら
goripon	ゴリぽん
takenohana	竹の花
nekomu	ねこむ
narikesoji	なりけそじ
naposhita	なぽした
shuri	シュリ
ayupon	あゆぽん
gitaharo	ギタハロ
dateatsushi	伊達敦
moyashi	もやし
zakura	ざくら
ruto	ると
komachi	こまち
akashino	赤篠
buren	ぶれん
kuro	くろ
imokonnu	いもこんぬ
tamanegi	たまねぎ
rei	零
peten	ぺてん
koke	こけ
metakuzu	メタクズ
miiko	みーこ
akirapa	アキラパ
denkichi	でんきち
ogawajunya	おがわじゅんや
egurin	えぐりん
moka	もか
kurotoriyuki	黒鳥ユキ
ebisuna	えびすな
pao	ぱお
nao	なお
minose	みのせ
tsukemono	漬物
kisasan	きささん
moka	もか
sana	サナ
hajikko	はじっこ
kyon	キョン
takeko	たけこ
wasabi	わさび
chu	ちゅ
sanue	さぬえ
meru	める
sena	瀬那
erui	ゑるゐ
neokiwaruko	ねおきわるこ
natsume	棗
tsuyoshi	つよし
mikage	みかげ
tsushi	ツシ
oruma	オルマ
buremega	ブレメガ
sayo	さよ
kuro	くろ
aoyami	蒼闇
koyakoya	こやこや
minamonte	みなもんて
machaki	まちゃき
kuro	くろ
reddoburu	レッドブル
hatori	はとり
souta	そう太
wanineko	鰐猫
misagosan	ミサゴさん
migiri	砌
miyu	みゆ
gunjou	群青
airakukaria	哀楽狩阿
hajikko	はじっこ
areumi	あれうみ
yanpa	やんぱ
momoyuki	桃雪
masanori	マサノリ
konoe	このえ
taichi	たいち
myumyuroro	みゅみゅろろ
masaka	まさか
kairi	かいり
kanisoru	カニそる
yoideai	良い出会い
pitotema	ぴとてま
gunjou	群青
paipankan	パイパン館
mefuyu	めふゆ
tonkun	とんくん
hamatani	濱谷
min	みん
hatori	はとり
okawari	おかわり
niugatsu	にぅがつ
kabahan	河馬半
rukia	ルキア
arakidonsan	あらきどんさん
edamame	えだまめ
kanoko	かのこ
yukorin	ゆこりん
pandakopanda	ぱんだｺぱんだ
komia	こみあ
yonesan	よねさん
sai	サイ
yasashiiwasabi	優しいワサビ
mero	めろ
kasumi	かすみ
ninsougaku	人相学
sumiya	スミヤ
fuuri	ふうり
andonkurage	あんどんくらげ
kabigon	カビゴン
nanaba	ななば
uchiko	うちコ
kuriyama	栗山
penkama	ぺんかま
kani	かに
metappou	メタッポウ
rue	ルエ
soruto	そると
koyuki	コユキ
aori	あおり
masaya	まさや
manekineko	招き猫
yukiguni	雪国
hitomi	ひとみ
monana	もなな
enma	えんま
mamesora	豆空
mirin	みりん
tobitanuki	とびタヌキ
aya	あや
bono	ぼの
aoneko	蒼ねこ
doguu	どぐう
yurari	ゆらり
shiratama	しらたま
riichan	りーちゃん
oiranonoriko	おいらの典子
pattsuan	ぱっつあん
mutsumi	ムツミ
nanashino	ななしの
hagina	萩奈
ojaemon	おじゃえもん
yoko	よこ
nepu	ねぷ
kuri	くり
hirai	ひらい
mio	みお
hiyo	ひよ
yorika	よりか
nekotamamizuki	ねこたまみずき
sakana	さヵな
massun	まっすん
kanamea	かなめあ
hirudoa	ひるどあ
saresare	されされ
ao	蒼
kawanotebukuro	革の手袋
sena	瀬那
himari	ひまり
non	のん
noma	ノマ
sayo	紗余
tokudane	とくだね
rune	ルネ
natsuki	なつき
kaatan	カータン
itoudaijirou	伊藤大二郎
ramiton	ラミトン
nekobaka	ネコばか
ichihiko	いちひこ
sangon	さんごん
kinjonooniisan	近所のお兄さん
romonemo	ろもねも
kino	きの
amano	あまの
kippo	きっぽ
bunmaro	ブンマロ
wabirukai	ワビル改
ibuki	伊吹
neko	ネコ
taiyaki	たいやき
oyajiseikatsu	オヤジ生活
kazushi	かずし
kayoyon	かよよん
miyao	みやお
kusooyaji	クソ親父
ayuto	あゆと
momodaisuki	もも大好き
umeshimeji	うめしめじ
chousuke	ちょうすけ
rio	りお
maria	まりあ
momoko	ももこ
ankake	あんかけ
kirenunko	キレヌンコ
yawara	やわら
murakurou	むらくろう
piorichan	ぴおりちゃん
mumudera	ムムデラ
hibiki	ひびき
aina	あいな
pie	ぴえ
kamishiro	カミシロ
ayamitsu	あやみつ
aoi	葵
kakerun	かけるん
imari	伊万里
asuka	あすか
ishiinoboru	石井昇
kuriko	栗子
sunekosuri	すねこすり
nijimikan	にじみかん
asahikamen	あさひかめん
hanamaruko	はなまるこ
kenniko	ケンニコ
mako	まこ
tomomin	ともみん
ukyou	右京
hasu	蓮
sakunatsu	さくなつ
yoshineko	よしねこ
nagomi	なごみ
yamosabo	やもさぼ
rii	りい
hitomisunaga	ヒトミスナガ
eha	えは
rikanojikan	理科の時間
torine	とりね
hazuki	葉月
naohiro	ナオヒロ
yuri	ゆり
koishi	小石
shin	しん
yamimaru	闇丸
iorin	いおりん
yakitori	やきとり
afusu	あふす
ken	けん
toshiaki	としあき
abunishu	アブニシュ
chiaki	ちあき
nyuutoraru	にゅーとらる
uju	うじゅ
kagijirou	かぎじろう
ririchan	リリちゃん
onigiri	おにぎり
rinnote	りんの手
morishi	森氏
sonjo	そんじょ
oreo	おれお
howaran	ほわらん
matcha	抹茶
aura	アウラ
kurosuke	くろすけ
kawau	かわう
sorairo	ソラいろ
yamainu	やまいぬ
menchi	めんち
nangororo	なんゴロロ
koa	こあ
kanaemon	かなえもん
fukuchan	ふくちゃん
masanyan	まさにゃん
yuyu	ゆゆ
takurou	ﾀｸﾛｳ
toshikin	としきん
maname	まなめ
channao	ちゃんなお
kouna	こうな
kyurio	キュリオ
inutose	いぬとせ
ringoame	りんご飴
oochii	おーちー
akaneko	赤猫
chapo	ちゃぽ
innaka	いんなか
yae	やえ
uhamomo	うはもも
shishimaru	ししまる
nanimonoka	なにものか
nemusuke	ねむすけ
rumarato	るまらと
chacha	ちゃちゃ
kyon	きょん
massa	マッサ
hirunokagayaki	昼の輝き
robina	ロビナ
tonmii	とんみぃ
chikasa	チカサ
makinanami	マキナナミ
sekken	せっけん
kamimama	かみまま
harada	原田
homeron	ホメロン
chitosa	ちとさ
akuchan	あくちゃん
dezaiya	でざいや
ojiji	おじじ
haribote	はりぼて
yasu	やす
eringi	えりんぎ
tomokichi	ともきち
techi	てち
ameusagi	飴うさぎ
oitake	おいたけ
mutsumi	むつみ
yamana	やまな
harineko	針猫
kabukin	かぶきん
suzune	すずね
ashioto	あしおと
asuka	あすか
saya	さや
gorichan	ゴリちゃん
jonasan	じょなさん
yasumasa	ヤスマサ
misaki	みさき
hijiki	ひじき
hamanasu	はまなす
muumi	むぅみ
hitomisan	ヒトミサン
fuafua	ふあふあ
rinkoro	りんころ
monika	モニカ
viru	ゔぃる
shiro	シロ
yuuku	ユーク
fumiko	ふみこ
hikarin	ひかりん
ochin	おちん
yuragi	ゆらぎ
yanun	やぬん
kotan	こたん
shutei	しゅてぃ
shioame	しおあめ
hidarime	ひだりめ
sumire	すみれ
sazuka	サズカ
tekunomo	てくのも
isoiso	イソイソ
yotsubanegi	よつばねぎ
kiyosuke	きよすけ
matchan	まっちゃん
kogeteru	焦げてる
fuu	ふぅ
torihiki	取引
souen	ソウエン
nagina	なぎな
chankaho	ちゃんかほ
shirako	しらこ
sachi	さち
daruhata	だるハタ
anto	アント
aruko	あるこ
rian	りあん
okayu	おかゆ
unyarin	うにゃりん
metappou	メタッポウ
parame	パラメ
inosan	いのさん
ayumun	あゆむん
kaaya	かぁや
akinohikage	あきのひかげ
pipizawachan	ぴぴざわちゃん
ayanon	あやのん
ginnosuke	ぎんのすけ
oniisan	お兄さん
anesakisu	あねさきす
shunya	駿ヤ
usagiotoko	うさぎおとこ
mokao	もかお
subaru	昴
tane	たね
mochidayori	もちだより
kanna	かんな
aonokurage	蒼乃海月
gumi	ぐみ
chunyuta	ちゅん由汰
nyun	にゅん
aoisora	あおいそら
dattan	韃靼
kamiyan	かみやん
yoshidahachi	吉田ハチ
miroku	みろく
ierahoki	いえらほき
mumu	むむ
koppepan	こっぺぱん
oyajiseikatsu	オヤジ生活
nanashiya	ななしや
natsumi	ナツミ
iori	伊織
oyajiseikatsu	オヤジ生活
pepo	ぺぽ
minoru	みのる
suzu	すず
kika	きか
meikun	めいくん
osamu	おさむ
amamizu	雨水
kurotoki	黒時
maoko	マオ子
mako	まこ
naoya	ナオヤ
migimimi	みぎみみ
misuzu	美鈴
adonisu	アドニス
konikoni	こにこに
sewashi	セワシ
botamochi	ボタモチ
kuria	くりあ
perie	ペリエ
aruru	あるる
bayashi	バヤシ
katsuguma	カツグマ
shunkoromochi	しゅんころもち
miruku	みるく
tsubaki	つばき
sasuga	流石
piyochan	ピヨちゃん
kanon	かのん
gorori	ゴロリ
naru	ナル
aasan	あーさん
mihokuma	みほくま
surippa	すりっぱ
kurosaki	くろさき
naochan	なおちゃん
yunha	ゆんは
yumeusagi	夢うさぎ
taka	鷹
aruru	あるる
yuzuringo	ゆずりんご
naoki	なおき
kapibara	カピバラ
nocha	のちゃ
wanta	わんた
katawara	かたわら
mochiyuri	もちゆり
yamosabo	やもさぼ
gekichin	げきちん
kurikuri	くりくり
tatsuya	たつや
hisame	氷雨
nunnun	ぬんぬん
yuuhaya	ゆうはや
tsuruse	つるせ
tokoton	トコトン
innaka	いんなか
kiyokazu	キヨカズ
kakerun	かけるん
okki	おっき
kochi	こち
apyapon	あぴゃぽん
isaki	いさき
kansho	かんしょ
kujira	鯨
haniwatarou	はにわたろう
tamako	たまこ
miharu	みはる
maikeru	まいける
mii	みぃ
miu	みう
ahiru	あひる
man	万
asuka	あすか
hiryupon	ひりゅぽん
surou	スロウ
junka	順遐
kuniyata	くにやた
teke	てけ
chisa	ちさ
yama	やま
mako	まこ
ahoneko	アホ猫
shigure	しぐれ
matsuo	まつお
norishiro	のりしろ
maruru	まるる
ojiraiyan	おぢらいやん
mohiko	もひこ
doreichou	奴隷長
choki	ちょき
misuzu	みすず
rinrin	りんりん
sora	そら
mizuki	みずき
masanashi	マサナシ
nao	なお
shachimaru	しゃちまる
okutan	おくたん
wami	わみ
karuma	カルマ
unchan	うんちゃん
kako	かこ
zawamin	ざわみん
sachinoka	さちのか
furipara	フリパラ
pucho	ぷちょ
shirako	しらこ
suzuhiro	すずひろ
kana	かな
kaitenma	回転魔
kazuha	かずは
ayase	あやせ
kurousa	クロウサ
yamai	山威
hayashiba	林葉
saki	さき
sanshichi	さんしち
majikayo	まじかよ
irukujira	イルクジラ
kodama	木霊
kumazeno	熊ゼノ
matsuoyuu	松尾優
akaneko	あかねこ
sasuga	流石
von	ヴォン
tenten	てんてん
munieru	ムニエル
shimazuyoshirin	島津よしりん
tomiwo	とみを
fujino	藤野
suika	すいか
hina	雛
kumasechi	くませち
akatsuki	暁
mariya	まりや
daichan	だいちゃん
oto	おと
mayako	まやこ
nebukuro	ネブクロ
takerenon	竹レノン
chizuru	千鶴
kako	かこ
hakuru	はくる
tsumurin	つむりん
yasaseka	やさせか
hoehoe	ほえほえ
dozuhiko	どずひこ
uriu	うりう
asakawarin	朝河凛
ani	アニ
kurokemu	くろけむ
nobirin	のびりん
neru	ねる
tsubaki	つばき
tamagopan	たまごパン
akaru	あかる
ki	キ
rokunoshin	ろくのしん
nekozakana	ねこざかな
kei	けい
jussai	じゅっさい
minori	みのり
sasasaboo	サササボー
take	竹
nenu	ネヌ
toyoninkun	とよにんくん
akame	アカメ
okiku	お菊
kimio	きみお
mugenimu	むげにむ
ninyau	ににゃう
daichan	大ちゃん
mahirokun	まひろくん
shiro	シロ
eruu	えるぅ
kokoro	こころ
sayagi	さやぎ
rei	零
tarosuke	たろすけ
hanabi	花火
kari	かり
moja	もじゃ
mauru	マウル
hirokonuna	ひろこぬな
maruta	まるた
kouichi	こういち
aruru	あるる
mio	みお
yahaku	やはく
ichigo	いちご
kokumaro	こくまろ
ratani	らたに
yasu	やす
momonochaya	桃乃茶屋
azuma	吾妻
wanineko	鰐猫
jou	じょう
yuki	ユキ
sora	そら
goetaro	ごえたろ
moka	もか
isasa	いささ
ochamaru	お茶丸
ten	天
aika	愛果
inui	いぬい
aru	アル
kamitaku	かみたく
muruun	ムルーン
reito	玲斗
urako	うらこ
yuki	ユキ
benihoku	べにほく
toneunga	利根運河
kyabetsu	きゃべつ
nakasan	なかさん
echinaba	えちなば
komekue	コメ食え
wakakuma	わかくま
tamayurakana	タマユラカナ
tooka	とおか
peroyan	ぺろやん
suzunekomaru	すずねこまる
mikan	みかん
zugashira	ズガシラ
awa	あわ
shirokuma	ｼﾛｸﾏ
gyanburupapa	ギャンブルパパ
yuzuyume	柚子夢
morichamo	もりちゃも
kumaneko	熊猫
tanakatakaaki	田中たかあき
taimama	たいママ
shioaji	シオアジ
aki	秋
temisuma	てみすま
harussan	はるっさん
kanii	かにい
hirakihokke	開きほっけ
kotone	琴音
saihatenousagi	さいはてのうさぎ
maru	まる
rikka	立夏
charisu	ちゃりす
gai	ガイ
non	のん
kiaimushi	気合虫
minamidori	みなみどり
mopiemon	もぴえもん
enso	塩素
minori	みのり
sabu	さぶ
gachi	ガチ
ayakari	あやかり
kantarou	観太郎
chanaka	ちゃなか
yuzuchan	ゆずちゃん
kaze	かぜ
nyarucha	にゃるちゃ
utausakana	歌う魚
morimori	もりもり
namepuri	なめぷり
sasakiyoshiaki	佐々木義明
ringo	りんご
sakurashiki	さくらしき
mii	みー
nono	ノノ
tetsutsu	テツツ
rui	ルイ
mayone	まよね
norimaki	のりまき
kussun	くっすん
ekanoa	エカノア
sameko	さめこ
notosan	のとさん
miriha	みりは
hisaki	ひさき
yasuroku	やすろく
mireraru	みれらる
oka	おか
neko	ネコ
yurariro	ゆらりろ
sui	スイ
kumo	蜘蛛
ginro	ぎんろ
umenori	梅海苔
rige	リゲ
aonekomochi	あおねこもち
tamaneko	たまねこ
erio	えりお
sabo	さぼ
honpo	ほんぽ
ponyorinko	ぽにょりんこ
yuki	ゆき
raika	ライカ
oinu	おいぬ
aberagi	あべらぎ
tarako	たらこ
sabo	さぼ
nona	のな
omomo	おもも
nohohon	のほほん
aniki	アニキ
kurobuchi	クロブチ
aya	あや
koyuki	こゆき
senma	せんま
roa	ロア
uguisu	鶯
fumi	ふみ
irasutooukoku	イラスト王国
anmitsu	あんみつ
posan	ぽさん
tsurimasamune	つり政宗
onoshi	おのし
wabisuke	わびすけ
yuzuha	柚葉
yuna	ゆな
kaorura	カオルラ
yunohana	湯の花
shinon	シノン
runachi	るなち
ume	うめ
ruda	ルダ
moyashi	もやし
atashidayo	あたしだょ
maya	マヤ
sujupon	すじゅぽん
nekohanten	猫飯店
kabocha	かぼちゃ
ikuru	いくる
niura	弐浦
naota	なお汰
hitomi	ひとみ
yunase	ゆなせ
todooka	トドオカ
takuya	たくや
manamin	まなみん
heita	へぃた
mame	まめ
kuro	クロ
natsuya	なつや
soraran	そららん
kusanagiyakumo	草薙八雲
momoka	ももか
nana	なな
mochinori	もちのり
rikka	立夏
mofumofu	もふもふ
ageha	あげは
kuroki	くろき
ahiruchan	あひるちゃん
chiapyoko	ちあぴょこ
yossan	よっさん
rimano	りまの
kuma	クマ
aika	あいか
shiopan	しおぱん
akauma	赤馬
kobaiya	故買屋
ito	いと
maeda	まえだ
aika	あいか
togetoge	トゲトゲ
hoshino	ほしの
koyayan	こややん
koubokin	酵母菌
irukujira	イルクジラ
miura	みうら
bichan	びちゃん
mitamaori	みたまおり
sayusayu	さゆさゆ
shirokuma	しろくま
runa	るな
hoheitokin	歩兵と金
ria	りあ
yamasaki	やまさき
oyachi	オヤチ
aoto	青斗
donamochi	どなもち
ayano	あやの
pietoro	ピエトロ
hippii	ひっぴー
mokoimo	もこいも
sonjo	そんじょ
orin	おりん
hiderin	ひでりん
razuru	ラズル
onotatsu	おのたつ
fusabanana	ふさバナナ
baran	ばらん
bachi	ばち
yukane	ゆかね
peru	ぺる
suzucha	すづちゃ
yoimonohyakka	良いモノ百科
kurose	黒瀬
mametana	まめたな
potepokari	ポテポカリ
miya	みや
kororin	ころりん
namuni	なむに
umatoge	うまとげ
reddoburu	レッドブル
ooiocha	おーいお茶
yumea	ゆめあ
yuzukichi	ユズきち
ryounoyume	遼の夢
sabure	さぶれ
daisuke	だいすけ
tadanotakemura	タダノタケムラ
hondamakoto	本田誠人
kaitoma	かいとま
fei	フェイ
shimarosan	しまろさん
atsumaru	あつまる
hinatsu	ひなつ
chiserakun	ちせらくん
kuma	くま
aoyami	蒼闇
ayako	アヤコ
ikameshi	いかめし
gegegenomosuke	ゲゲゲのもすけ
bareru	バレル
roze	ろぜ
kazunoko	かずのこ
kuroneko	くろねこ
potepokari	ポテポカリ
kakapo	カカポ
nousagi	野うさぎ
takubochan	たくぼちゃん
kuru	くる
kanto	間徒
dedededede	ででででで
korochan	ころちゃん
iriko	いりこ
konitan	コニタン
mai	まい
sora	空
dabochan	ダボちゃん
hosoaki	ほそあき
boyakenasu	ボヤケナス
tanakapunie	田中ぷにえ
mukkoro	むっころ
yukino	雪乃
kinoruto	きのると
kisa	キサ
kureyon	くれよん
aoiyana	葵やな
nanakomama	ナナコママ
iroha	いろは
kirin	キリン
miyano	宮野
taso	たそ
omusubi	おむすび
nao	なぉ
ikanuko	いかぬこ
namipika	なみピカ
makaronidesu	まかろにです
kotokotoheron	ことことへろん
monmon	もんもん
takapoyo	たかぽよ
kukka	くっか
aki	あき
harumaki	ハルマキ
akashino	赤篠
yuno	ゆの
ramune	らむね
ryoupon	りょうぽん
koketakokeko	苔田苔子
kaori	かおり
mosuke	もすけ
mochiri	もちり
shin	しん
akizukiusagi	秋月うさぎ
hamano	濱埜
yuuka	ゆうか
kii	きぃ
atamanbou	あたまんぼう
hiyorin	ひよりん
pokotanmaru	ぽこたんまる
momijidori	もみじどり
aichun	あいちゅん
dateme	だてめ
isonaudon	磯菜うどん
yutorin	ゆとりん
chitonyan	ちとにゃん
bakanshu	ばかんしゅ
pandakopanda	ぱんだｺぱんだ
osora	おそら
teruyaki	てるやき
miyaso	みやそ
arupaka	アルパカ
akane	あかね
terapon	てらぽん
yukimi	雪見
kamicha	かみちゃ
kokoro	こころ
kitasamurai	きたさむらい
haruichi	ハルイチ
kome	米
zouri	ゾウリ
rion	りおん
mossan	もっさん
naratsujichan	ならつじちゃん
kuro	くろ
hiderin	ひでりん
hirorin	ひろりん
toyosan	とよさん
marimo	まりも
yonadororo	ヨナどろろ
takehide	たけひで
miyabi	みやび
tomatoneko	トマトねこ
hanayuu	はなゆー
sopapa	ソパパ
maronpapa	マロンパパ
yuyuutaouentai	ゆゆうた応援隊
kasumin	かすみん
kotsubu	こつぶ
ajihei	あじへい
tsumutsumu	つむつむ
yamanaka	ヤマナカ
nobu	のぶ
ikumin	いくみん
unizanmai	うにざんまい
takaman	タカマン
tadon	たどん
narumi	なるみ
tsukaima	使い魔
monpuchi	もんぷち
nenenyanparari	ねねにゃんぱらり
hano	葉野
yumetanpo	ゆめたんぽ
haiji	はいじ
ukeu	うけう
nanashin	ナナシン
norausagi	野良兎
gururin	ぐるりん
daibutsupurin	ダイブツプリン
nekomatasan	ねこまたさん
wanta	碗太
dougahakusho	動画白書
tsubasa	つばさ
aki	あき
anna	あんな
emohichi	えもひち
mikoma	みこま
mayoyoyoyoyoyo	まよよよよよよ
hokusei	北西
akiya	亜紀矢
mozukushiho	もずくしほ
reno	れの
neruson	ねるそん
momiji	もみじ
mumumu	むむむ
nagaharu	ながはる
kunto	くんと
asuta	あすた
amaebi	あまえび
yamichan	やみちゃん
torikomeigen	トリコ名言
kikuchi	菊池
bara	バラ
puku	ぷく
oioi	おいおい
mikuru	みくる
okapi	おかぴ
ama	海人
yuua	ゆぅあ
yuachacha	ゆあちゃちゃ
miyanagaharu	宮永ハル
keron	けろん
sakuranbo	さくらんぼ
kokoa	ここあ
fusakichi	ふさきち
sanchan	さんちゃん
misagosan	ミサゴさん
kame	カメ
puredora	プレドラ
hide	ヒデ
ajisai	紫陽花
natsumaru	夏丸
kisaka	木坂
nowaka	のわか
inunoshippo	犬の尻尾
akahappasan	赤はっぱさん
ponyo	ぽにょ
raion	らいおん
haruame	はるあめ
hose	ホセ
season	せあそん
kappachou	河童長
kakioaruaru	柿生あるある
aokiyoshiaki	青木義明
daraku	駄楽
sunono	すのの
yaken	やけん
kisaragi	きさらぎ
chihaya	ちはや
senri	センリ
yuzuki	ユズキ
nounaiyousei	脳内妖精
kujoo	くじょー
okabadazo	おかばだぞ
fumiya	ふみや
meru	める
nasunasuno	なすなすの
suzufin	すずふぃん
mikuku	みくく
sayaka	さやか
buremega	ブレメガ
hiroshi	ひろし
omameyama	おまめやま
kinako	きなこ
rinnu	りんぬ
nodoka	長閑
akkun	あっくん
nopua	ノプア
miraikun	みらいくん
yoshikawayukiji	よしかわゆきじ
apopo	あぽぽ
tomo	とも
mochikuma	もちクマ
setsuna	刹那
chie	千絵
shiretto	シレット
kiramekuantena	キラメくアンテナ
genkidaseyo	元気出せよ
ugounoyakara	烏合の輩
usapi	うさぴ
shinodaremu	篠田レム
deno	での
kurumi	くるみ
akibachiyo	秋葉ちよ
kaitoma	かいとま
gesokingu	げそきんぐ
buremega	ブレメガ
matsuse	松瀬
komame	こまめ
nekonohikidashi	ねこの引出し
sunono	すのの
masaya	まさや
kuiijisokuhou	食い意地速報
yaminoma	やみのま
mea	めあ
soraten	空テン
tareusagi	たれ兎
nodoka	長閑
mikichanmaru	みきちゃんまる
hakua	ハクア
atomaru	あとまる
amio	あみお
murao	ムラオ
puku	ぷく
kasutaamu	かすたぁむ
doushikaro	同志カロ
akeusume	あけうすめ
sakuramaru	さくらまる
marukawa	まるかわ
kanaan	かなあん
kamo	かも
takasan	たかさん
totomaru	ととまる
akeusume	あけうすめ
hiryupon	ひりゅぽん
waranpo	わらんぽ
fujikun	ふじくん
matsuse	松瀬
kon	こん
suzumarimaruko	すずまりまるこ
eminyanpe	えみにゃんぺ
kazu	かず
igarashi	五十嵐
nekononyaa	ねこのにゃぁ
okamo	おかも
yuuki	ゆうき
naminamina	ナミナミナ
kanon	カノン
katana	かたな
usokusai	嘘苦斎
ichi	壱
rei	レイ
kon	こん
mugicha	麦茶
kinugitsune	絹ギツネ
torosuke	トロすけ
ondeko	おんでこ
karaagekun	からあげクン
imokenpii	芋けんぴぃ
sabutama	さぶたま
sakamotokikaku	坂本企画
paipankan	パイパン館
tsukimi	月見
erumisu	エルミス
anegoroku	姐御録
yamasa	やまさ
nugino	ぬぎの
kikuru	きくる
hayabusa	はやぶさ
anmochizouni	餡もち雑煮
azumamaro	あずままろ
kayo	かよ
miya	みや
rukibe	ルキベ
yakumo	八雲
yayoimochi	弥生餅
shirohan	しろはん
shiopan	しおぱん
mirai	みらい
daichan	だいちゃん
rei	れい
hana	はな
setouchiniboshi	瀬戸内にぼし
ruiru	ルイル
pepo	ぺぽ
ohanaya	お鼻屋
omochineko	おもちねこ
furapamyu	ふらパミュ
yami	やみ
otoko	おと子
kuroyuki	黒雪
haruse	春瀬
darakou	だらこう
rozemu	ロゼム
seinozatsugaku	性の雑学
wasabi	わさび
usapi	うさぴ
kohina	こひな
yuutorin	ユートリン
ayayan	あややん
magi	マギ
subapero	すばぺろ
denkiusagi	電気ウサギ
kureara	クレアラ
umetama	うめたま
maru	まる
ukinamegumi	浮名恵
mizu	みづ
matsuri	まつリ
domonnoaniki	ドモンのアニキ
mairu	まいる
karin	カリン
rimuten	りむてん
sakkin	殺菌
guraburuyouaka	ぐらぶる用垢
gyaodayo	ぎゃおだよ
karu	カル
taruto	たると
sona	そな
niwahokori	にわほこり
shiina	しいな
nin	にん
waserin	ﾜｾﾘﾝ
ai	あい
chitchima	ちっちま
iyo	伊予
kintarou	金太郎
rikopin	リコピン
keron	けろん
murasaki	むらさき
saruyama	猿山
odango	おだんご
nerusame	ネルサメ
nemukun	眠くん
ruto	ると
toramaru	とらまる
okara	おから
hinomarukougyou	日の丸興業
rai	徠
kamyu	かみゅ
tekkimon	テッキモン
mizuhime	水姫
konoichi	このいち
himari	ひまり
urudo	うるど
miyu	みゆ
fuji	ふじ
rururu	るるる
tatami	たたみ
yuzuame	ゆずあめ
soragon	ソラゴン
suguru	スグル
nugayan	脱がやん
haniwa	はにわ
tamabarin	たまばりん
tansangyuunyuu	炭酸牛乳
koba	こば
yutoride	湯砦
akametakuya	アカメタクヤ
asakune	あさクネ
akito	アキト
masa	まさ
roroppo	ろろっぽ
kusamochi	草餅
mitomaton	ミトマトン
amami	あまみ
nishikawa	西川
sakiika	さきいか
kururinu	くるりぬ
arai	あらい
kyon	キョン
yuukiyukio	結城ゆきお
kagakouhei	加賀浩平
ryoo	りょー
kamokuma	カモクマ
kururinu	くるりぬ
komasan	コマさん
wanko	わんこ
pochakoro	ぽちゃころ
zouri	ゾウリ
yunyu	ゆんゆ
zaorarukure	ザオラルくれ
fujimako	ふじまこ
karakusa	唐草
mao	まお
neneko	ねねこ
beriko	べりこ
seijiyou	政治用
bayarun	バヤルん
nemu	ねむ
watarininja	ワタリニンジャ
nyashimashi	にゃしまし
akaban	あかばん
sugi	すぎ
mokuzu	もくず
wanko	わんこ
ameten	あめてん
umekarubo	梅カルボ
saya	さや
nyarumaru	にゃる丸
piyochan	ぴよちゃん
hatomugi	はと麦
akaru	あかる
rume	るめ
setsu	せつ
toichi	トイチ
aochin	あおちん
yukimi	雪見
wanko	ワン子
tomatodaisuki	トマト大好き
tapiokapan	たぴおかぱん
yamatai	やまたい
runa	るな
sayaya	さやや
marin	まりん
rieru	りえる
hachie	はちえ
makiho	牧歩
oshin	おしん
yamada	山田
kibino	きびの
surume	するめ
ragu	らぐ
kitayume	きたゆめ
kibimeika	きびめいか
makoto	真
ayagon	あやごん
kisayuva	きさゆゔぁ
chanmanjirou	ちゃんまんじろう
kon	こん
akami	あかみ
rimaru	リマル
tadashiichiyoko	多田椎千代子
ten	てん
nofu	のふ
ruina	るいな
naken	なけん
suwachiru	すわちる
shura	しゅら
matcha	まっちゃ
usagipanchi	うさぎぱんち
arishia	アリシア
gumi	ぐみ
maru	まる
chibi	ちび
nijinohitomi	虹乃瞳
yaneuranoneko	屋根裏の猫
gojou	五条
okimiyage	おきみやげ
katariya	カタリヤ
yamaemon	ヤマエモン
moriyuki	モリユキ
hitsu	ひつ
ayane	あやね
nakunaku	なくなく
chiyama	ちやま
yamada	山田
sakurasan	佐倉さん
chama	ちゃま
yaku	やく
enna	えんな
vaora	ヴァオラ
donapika	ドナピカ
miwato	みわと
puramisuto	ぷらみすと
kusa	草
sechiyuu	セチユウ
ikaringu	いかりんぐ
daraku	駄楽
toukaichuukosha	東海中古車
nae	なえ
miyakumo	みやくも
mizukiri	ミズキリ
kaeru	カエル
kotora	ことら
mintosu	みんとす
nobosan	のぼさん
yamana	やまな
ayubosu	あゆぼす
tamai	たまい
kurosu	クロス
takkun	たっくん
azuki	あずき
a	あ
pen	ぺん
suama	すあま
yukina	由希奈
noranekoinko	野良猫鸚哥
mansaku	まんさく
kyuu	きゅう
iyo	いよ
takatoshi	タカトシ
age	あげ
misapon	みさぽん
ruru	るる
chio	ちお
kisarazurisu	木更津りす
same	さめ
kumasan	くまさん
takanori	たかのり
seratamiruku	せらたみるく
risapapa	リサパパ
chanhaa	ちゃんはー
kinakoramune	きなこらむね
matsuko	まつ子
sou	ソウ
kousuke	こうすけ
monota	もの太
maru	まる
okekichi	おけきち
tsumugi	つむぎ
shibasen	しばせん
choshio	ちょしお
kiku	キク
neko	ねこ
arakisou	荒木荘
chika	知佳
echigonouguu	越後のうぐぅ
gayako	がやこ
sakabon	さかぼん
kaisui	海水
kugaruga	くがるが
agohige	あごひげ
sayupapa	さゆぱぱ
sahakuieru	サハクィエル
hisui	ヒスイ
garamani	ガラマニ
kuga	くが
otomorin	おともりん
kani	かに
potechin	ぽてちん
chii	ちぃ
tetsuo	テツオ
aoonikun	青鬼くん
rarira	らりら
yuan	ユアン
hirohige	ひろひげ
mayuka	ﾏﾕｶ
hibippi	ひびっぴ
mikan	みかん
nanchara	なんちゃら
tararebatarou	たられば太郎
mameshiba	マメシバ
yorusuzume	夜雀
kuroneko	黒猫
yamadori	やまどり
zenitora	ぜにとら
nono	のの
utatane	うたたね
papiron	ぱぴろん
fujino	藤野
ruripon	るりぽん
kutsushita	くつした
yasakani	ヤサカニ
tomomi	ともみ
risamichi	りさみち
himagami	ひまがみ
tororoimo	とろろいも
kujira	くじら
sakuraipan	さくらいぱん
makiyan	まきやん
yukanko	ゆかんこ
hayasemegumi	早瀬めぐみ
izumi	いずみ
nasuneko	ナス猫
mutekiman	むてきまん
ayashimiken	あやしみけん
mutekiman	むてきまん
aochin	あおちん
tararebatarou	たられば太郎
kakka	かっか
nororoma	のろろま
miyuki	みゆき
rea	れあ
makimune	マキムネ
kimi	きみ
takeshi	たけし
jirosansan	じろさんさん
mongo	モンゴ
suzuse	鈴瀬
tokisora	ときそら
nekomon	ねこモン
kamikou	カミコウ
saichi	さいち
momomomotarou	ももももたろう
kotonoki	ことのき
hina	ひな
kenhika	けんひか
kaneyan	かねやん
kinakonaki	きなこな木
setchan	せっちゃん
hamudorubu	ハムドルブ
somechin	そめちん
izumotori	いずもとり
asatte	あさって
runoku	るのく
sakura	さくら
haru	はる
kawa	かわ
wanusan	わぬさん
kira	きら
hiyameshi	ヒヤメ氏
ottsu	おっつ
nagi	ナギ
rito	リト
napi	なぴ
kuroneko	くろねこ
yuayu	ゆあゆ
yamana	やまな
mayura	まゆら
koyuki	こゆき
rike	りけ
meronguma	メロングマ
yasushi	やすし
hide	ヒデ
sunawo	スナヲ
ririn	りりん
safaia	さふぁいあ
hayato	はやと
yumitakku	ゆみたっく
miwamiwa	みわみわ
sona	そな
momokonohaha	桃子の母
norisan	のりさん
ringo	りんご
norisan	のりさん
hayatasaka	はやたさか
minasuke	みなすけ
asuka	明日香
harapeko	はらぺこ
mugi	ムギ
banana	バナナ
pikadeon	ピカデォン
yasu	やす
shunya	駿ヤ
koujirou	こうじろう
kurapi	くらぴ
saki	さき
higepon	ヒゲポン
suima	睡魔
airi	あいり
nachukabako	ナチュカバコ
wafutarou	わふ太郎
kobomasa	コボマサ
moemoeaniani	もえもえアニアニ
matsuko	まつ子
hyakushou	百姓
miapyu	みあぴゅ
irohasu	いろはす
norisan	のりさん
keizou	けいぞう
myuu	みゅう
iku	郁
shizukuri	しずくり
seira	せいら
matsuiruriko	松井るり子
mobo	モボ
moguneko	もぐねこ
urashimatarou	浦島タロウ
yoshiruna	よしるな
nata	なた
nekomikan	ねこみかん
yuge	湯気
maatarou	まあたろう
orugafujin	オルガ夫人
bokusama	僕様
ito	いと
hinaki	ひなき
aratapi	あらたぴ
omochi	おもち
harima	播磨
himajin	暇人
takosensei	タコ先生
akarin	あかりん
manriki	まんりき
supiripi	すぴリピ
kaiu	かいう
poriko	ぽりこ
koyu	こゆ
miiko	ミーコ
mugi	ムギ
kuroi	くろい
mizuame	水飴
kugaruga	くがるが
neharitomo	ねはりとも
yuka	ゆか
kyoudaiaruaru	兄弟あるある
nizou	にぞう
emyu	えみゅ
taragyon	たらぎょん
kanaton	かなとん
naomin	なおみん
tora	とら
onboro	おんぼろ
abuhide	あぶヒデ
kasokai	過疎界
kakinokitane	柿ノ木タネ
chakenoko	ちゃけのこ
tenpa	てんぱ
chipi	ちぴ
kanao	かなお
sumisu	スミス
totoro	ﾄﾄﾛ
reokun	レオくん
mametaro	まめたろ
kamiyome	神嫁
ren	れん
sakurasaku	さくらさく
pentan	ぺんたん
mochimochi	もち餅
burian	ブリアン
tao	タオ
somosomo	そもそも
himagami	ひまがみ
momo	もも
nekosaba	猫鯖
sasami	ささみ
inufugu	いぬふぐ
irieyuka	入江由香
soramame	そらまめ
nanano	ななの
pietoro	ピエトロ
kobachi	小鉢
shiichan	しーちゃん
himawari	向日葵
sanosu	さのす
koshaken	こしゃけん
toyotaku	とよたく
minato	みなと
sayo	小夜
hemonosuke	へものすけ
kagerin	かげりん
ikopiko	いこぴこ
ayaka	あやか
burian	ブリアン
azamikage	あざみかげ
takusama	拓さま
kiyotaka	キヨタカ
kazunoko	数の子
hirokun	ひろくん
nino	にの
tomiko	とみこ
kumaken	くまけん
sunohara	すのはら
gusoku	ぐそく
taiyaki	たいやき
yutabouzu	ゆたぼうず
dino	ディノ
myun	みゅん
ponyodora	ぽにょどら
obarin	おばりん
asakibenio	朝喜紅緒
yutasan	ゆたさん
kabuya	カブや
daimon	大門
setsuna	せつな
asuina	アスイナ
surizuni	すりずに
tanbo	田んぼ
botamochi	ぼた餅
momozou	ももぞう
yuma	ユマ
umeko	うめ子
mikan	みかん
dai	だい
momocha	ももちゃ
umemura	うめむら
wakadoshiyori	若年寄
mitsubachi	蜜蜂
wadamii	わだみぃ
mamoru	マモル
rito	りと
anyakuma	あにゃくま
imaoka	いまおか
suginohiko	杉野ひこ
nakayan	なかやん
bonkura	ぼんくら
daifukukun	だいふくくん
sonon	そのん
kaimu	カイム
mesomeso	めそめそ
nemuri	ねむり
mikuso	みくそ
dokurun	どくるん
kurono	クロノ
tayuu	多遊
hitomisan	ヒトミサン
chansoku	ちゃん速
kayu	かゆ
nakasan	中さん
kusumi	くすみ
risakoron	りさころん
dabukuro	ダブクロ
safia	サフィア
kenmorokoshi	けんもろこし
rei	玲
fuku	ふく
aina	あいな
kohepero	コヘペロ
kou	こう
tomakomaioniku	苫小牧おにく
kirosaki	キロサキ
matsugorou	まつごろう
suzuka	スズカ
mitomikan	みとみかん
ai	あい
torisan	鳥さん
taroutaroutaoru	太郎太郎タオル
jikkun	じっくん
kanimaru	かにまる
morishima	もりしま
jintai	じんたい
aratomo	あらトモ
oyajiseikatsu	オヤジ生活
agarie	あがりえ
yuppi	ゆっぴ
yuu	憂
nasuko	なすこ
minakawa	みなかわ
hika	ヒカ
mikemaneki	三毛招き
ishiminekei	石嶺経
moe	もえ
kiwamochi	きわもち
ajiran	あじらん
kuromame	くろまめ
kokeshichan	こけしちゃん
rin	凛
uepon	うえぽん
makana	まかな
yakumo	八雲
mizuki	ミズキ
takua	たくあ
kinkin	キンキン
tobu	トブ
daohiko	だおひこ
ushidai	うしだい
marurun	まるるん
usajiu	うさじう
sora	そら
satoko	さとこ
takipon	たきぽん
nekosaba	猫鯖
goki	ゴキ
daimon	大門
oto	おと
shiodoki	潮時
hironohiro	ヒロノヒロ
kichida	きちだ
aya	あや
hirowa	ひろわ
aitoyokubou	愛と欲望
kekke	けっけ
yamabuki	山吹
maru	まる
kayanon	かやのん
kanoe	かのえ
hisashi	ヒサシ
sena	セナ
yamadori	やまどり
rorinon	ろりのん
ino	いの
noriko	のりこ
chiemaru	ちえまる
gyonami	ぎょなみ
iri	イリ
sumirei	すみれい
natsu	なつ
tomoya	ともや
yuuki	ゆうき
natsupo	なつぽ
amedama	あめだま
nemui	ねむい
yopi	よぴ
mayuka	麻由佳
natsu	なつ
botamochi	ぼたもち
yui	ゆい
mikemaneki	三毛招き
kakekomi	かけこみ
sui	すい
aonekomochi	あおねこもち
satoshi	さとし
ino	いの
kuroken	クロケン
sakikumi	咲組
nina	にな
tanadatakashi	棚田たかし
arisun	ありすん
nekoara	ねこあら
keitaro	けいたろ
kuroshiba	黒柴
takenoko	たけのこ
saeko	冴子
kota	コタ
erumisu	エルミス
moono	もーの
penjin	ぺんじん
naitomea	ナイトメア
shina	しな
umetani	梅谷
saki	さき
rindou	凛銅
maotarou	まおたろう
seki	堰
atomu	あとむ
hirudoa	ひるどあ
yamanoiokota	山ノ井おこた
kurohegyo	黒ヘギョ
samurai	サムライ
natsumi	なつみ
sabakan	サバ缶
aika	あいか
marunana	まるなな
nijiomu	にじおむ
yazako	やざこ
yottan	ヨッタン
samosumire	さもスミレ
rian	りあん
sansasu	さんさす
kenken	ケンケン
mofufu	モフフ
kaede	かえで
yowamode	よわもで
nerusame	ネルサメ
zarukieru	ザルキエル
yawaraka	やわらか
rena	れな
mocha	もちゃ
kurageno	くらげの
mayu	まゆ
shoge	しょげ
akasa	あかさ
moyoko	もよこ
chibitan	ちびたん
seiten	青天
akinosakura	秋乃桜
kotona	ことな
ryon	りょん
nekomaru	猫丸
maruchan	まるちゃん
ryou	りょう
kichiki	きちき
machi	まち
poppo	ぽっぽ
wataame	わたあめ
marumaru	まるまる
aoi	あおい
sauchi	さうち
chibiusachan	チビうさちゃん
guriparu	ぐりぱる
omameyama	おまめやま
kurokuma	くろくま
nekoroji	猫路地
pikarin	ピカリン
chankako	ちゃんかこ
rarea	られあ
muramasu	むらます
eiroku	永禄
shun	しゅん
hiyokoneko	ひよこねこ
mikeneko	みけねこ
kiriyume	きりゆめ
muu	むぅ
yokkorari	よっこらり
yuuhi	ゆうひ
yamana	やまな
kaho	かほ
nekoharasan	猫原さん
subaru	昴
haru	はる
kauri	かうり
pukudori	プクドリ
nui	ぬゐ
ame	あめ
bakatsu	ばかつ
sora	そら
ayasama	あやさま
shiatoro	しあとろ
wanikaku	鰐劃
imaoka	いまおか
puko	ぷこ
toto	とと
richo	りちょ
kokebanana	コケバナナ
tongu	とんぐ
kotono	琴乃
gensaku	げんさく
zenigata	銭形
sakurako	さくらこ
adachimikiyo	足立みきよ
tomoyan	ともやん
tsukiyonopanda	月夜のパンダ
ikemako	いけまこ
nagi	なぎ
chanosuke	ちゃのすけ
manekineko	招き猫
amemura	雨村
toshikou	としこう
douka	銅貨
karaisu	からいす
kamonegi	かもねぎ
azu	あず
yukipen	ゆきペン
saya	沙弥
machopi	まちょぴ
kimushin	きむしん
yuuki	ユウキ
ami	あみ
nanane	ななね
taayun	たあゆん
ja	じゃ
harukuji	はるくじ
hiropon	ひろぽん
aira	姶良
konatakamin	こなたかみん
damurin	だむりん
onigiripan	おにぎりぱん
tetsutsu	テツツ
ririmon	りりもん
shichi	しち
shake	しゃけ
taiyoumarii	太陽まりい
itton	イットン
mahiru	真昼
fuu	ふぅ
atomi	あとみ
yuno	ゆの
keshigomuyama	消しゴム山
aono	あおの
maggyo	マッギョ
hanakuro	はなくろ
otetetsunaide	お手てつないで
kawo	かを
okan	おかん
ranmaru	らんまる
sakamichi	坂道
anitetsu	アニてつ
rirutaru	りるたる
hamigakiman	はみがきまん
inoneko	いのねこ
misora	み空
hinata	ひなた
maru	まる
sea	せあ
irikome	いりこめ
akira	晃
kirinoorehana	霧野俺はな
sabae	さばえ
seto	瀬戸
kassan	かっさん
kemumaki	ケムマキ
emukun	えむくん
yuki	ユキ
akazashigure	赤座しぐれ
kurofuku	くろふく
nekome	猫目
tare	たれ
yui	ゆい
kiyomiya	キヨミヤ
honoyuto	ほのゆと
pakira	パキラ
kugiko	釘子
ezume	えずめ
tarefu	たれふ
pauro	ぱうろ
yura	ゆら
ikenokaeru	池野蛙
masamisan	まさみさん
iruka	ぃるか
makumaku	まくまく
sarusu	さるす
miyabi	みやび
ito	いと
takapi	たかぴ
umeko	ウメコ
hina	ひな
ebinotataki	エビのたたき
asa	麻
kaiwarehimawari	貝割向日葵
hiwano	ひわの
yukiyanagi	ゆきやなぎ
sayo	さよ
takuya	たくや
soran	ソラン
nanaba	ななば
mukichan	むきちゃん
sono	曾野
yaku	やく
umihana	うみはな
kanaroa	カナロア
ririi	りりぃ
chiba	ちば
seto	瀬戸
kakeru	カケル
asuko	あすこ
sakamoto	サカモト
mayugekoijirou	まゆげ恋二郎
hiyopotechi	ひよぽてち
kouno	こうの
puripon	ぷりぽん
piyopiyomen	ピヨピヨ麺
serori	せろり
nonono	ののの
hijiri	聖
kawagon	かわごん
bebeben	べべべん
henboku	へんぼく
utano	歌野
akasaka	あかさか
sekibon	セキボン
nikuya	肉屋
hamanasu	はまなす
morichamo	もりちゃも
kamegonta	かめゴン太
yuina	ゆいな
yuina	ゆいな
tsukasa	ツカサ
nero	ねろ
toma	トマ
shio	シオ
hibiki	ヒビキ
tokoton	トコトン
hina	ひな
raiga	ライガ
nyanyayasan	にゃにゃやさん
bunkakakumei	文化革命
kameyama	かめやま
yakamashiiyatsu	やかましい奴
ikamariko	イカまりこ
madao	マダオ
neon	ネオン
itsuki	いつき
tamago	たまご
shamu	シャム
umaaji	うまあじ
mamadon	ままどん
konishitama	小西たま
rinma	りんま
satoru	サトル
mitsubanowakaba	みつばの若葉
kiyomasa	きよまさ
meroo	メロー
peruru	ペるる
reefa	れーふぁ
bon	ぼん
momosakura	桃桜
maaku	まあく
kaigaraika	かいがらいか
morimizue	森水絵
ito	いと
oshiomaru	おしおまる
oro	おろ
kunieda	くにえだ
mirakuruore	みらくるおレ
matcha	まっちゃ
watarininja	ワタリニンジャ
korokke	ころっけ
momo	もも
mizuirotarou	水色太郎
ayuyu	あゆゆ
muyuno	むゆの
zupi	ずぴ
kinase	きなせ
katsunori	かつのり
karasuno	からすの
akatsukiyuu	暁ユウ
nunnun	ぬんぬん
chikuwa	ちくわ
toshi	トシ
yunamei	ユナメイ
mugicha	麦ちゃ
himari	ひまり
morige	もりげ
udon	うどん
rena	れな
mayuchiki	まゆちき
yuna	ユナ
pyoko	ぴょこ
pukurin	ぷくりん
noi	のい
ooji	大路
mekki	めっき
toeshin	トエシン
daifuku	大福
natsumaru	なつまる
mimikkyu	みみっきゅ
namichin	なみちん
hatsuki	はつき
take	タケ
asajiri	アサジリ
kodou	コドウ
miyagawa	みやがわ
sujiniku	すじにく
hitsuji	未
shion	紫苑
sousaku	創作
funashi	ふなし
rui	るい
akiaki	あきあき
noemichi	のえみち
asajiri	アサジリ
gumi	グミ
amakuchi	甘口
ayu	あゆ
techi	てち
harami	ハラミ
akikan	空き缶
kisara	きさら
zakishin	ざきしん
kana	かな
nikaji	にかじ
tomo	とも
manabi	まなび
yuniko	ゆにこ
haruya	はるや
hiru	ひる
yu	湯
tachiaki	タチアキ
hosoaki	ほそあき
kyania	キャニア
tomozou	ともぞう
take	たけ
emisota	えみそた
misumaru	みすまる
yuuri	悠莉
kuroki	黒樹
kuwatoro	クワトロ
yukio	ユキオ
harapekokun	はらぺこくん
saritote	さりとて
yometoruto	嫁トルト
horijin	ほりじん
sakina	咲奈
ujippi	うじっぴ
besu	ベス
koma	こま
boshi	ぼし
anto	アント
hiyori	日和
aruzero	アルゼロ
hachimitsu	はちみつ
channemu	ちゃんねむ
reirei	れいれい
shizuwo	しずを
hirunokagayaki	昼の輝き
maru	まる
tenkinoko	天キノコ
yuyuyu	ゆゆゆ
tomato	とまと
kokumaro	こくまろ
karisuke	かりすけ
kuroganemushi	クロガネ虫
shion	しおん
nanoyume	なのゆめ
eririn	えりりん
amamizu	雨水
himajin	暇人
roase	ろあせ
tamimukemaru	たみむけ丸
okiku	お菊
utacha	うたちゃ
piyopiyomen	ピヨピヨ麺
chikuwa	ちくわ
shinji	シンジ
koyayakawa	こややかわ
okimaru	オキ丸
sanmasan	さんまさん
pan	ぱん
mofuusa	もふうさ
hayashi	林
yuno	ゆの
shimaimama	姉妹ママ
kimuchi	きむち
unimayu	うにまゆ
kisa	木佐
morumotto	モルモット
bishoujo	美少女
nanochan	なのちゃん
tsubaki	つばき
kanata	かなた
seto	せと
aikun	藍くん
erinya	えりにゃ
ichi	いち
kuri	くり
ena	ぇな
koyuki	こゆき
rojii	ろじぃ
yukiyuna	ゆきゆな
namekonbu	なめこんぶ
akinohikage	あきのひかげ
suke	すけ
kamiyan	かみやん
tonmii	とんみぃ
yasuhiro	ヤスヒロ
muyatan	むやたん
itau	いたう
shiroto	シロト
koamin	こあみん
nekomeji	ネコメジ
wanko	わんこ
hanada	花田
sakiko	ｻｷｺ
yuna	ゆな
kenbou	ケン坊
opun	おぷん
kuroha	くろは
mame	ﾏﾒ
dai	だい
hiyori	日和
neko	ねこ
popo	ぽぽ
gorosuke	ごろすけ
amadai	アマダイ
tachiaki	タチアキ
nami	波
kasane	かさね
yasuponta	やすポン太
mebiaru	メビアル
mayatahi	ﾏﾔﾀﾋ
mutou	無糖
saki	さき
rani	ラニ
monogusa	ものぐさ
sahonchin	さほんちん
gonta	ごん太
mia	みあ
maikeru	まいける
mayamaya	マヤマヤ
sabamiso	さばみそ
renon	れのん
mashiro	ましろ
toku	とく
kageneko	影猫
maki	マキ
miya	みや
roteri	ろてり
rikka	りっか
haruharu	はるはる
kakawo	カカヲ
yasapen	やさぺん
mayobushi	まよぶし
romomo	ろもも
kamui	かむい
gomasaba	ごまさば
mikaba	ミカバ
satone	さとね
akaganesaru	あかがねさる
kusadangotarou	草団子太郎
hessan	へっさん
hirunikurai	ひるにくらい
kirameki	キラメキ
owabon	おわぼん
usagineko	うさぎねこ
rara	らら
yuuki	ゆうき
hauru	はうる
aru	ある
yuki	ユキ
akane	あかね
misagosan	ミサゴさん
isojin	イソジン
natsu	なつ
ene	エネ
fuyoshin	ふょしん
kirikiriman	キリキリマン
nikoneko	にこねこ
maru	まる
minase	みなせ
owaten	オワテン
ogatake	オガタケ
jasei	じゃせい
hayatomi	ハヤトみ
yamada	山田
mokenokemo	もけのけも
kaorin	かおりん
harisenbon	はりせんぼん
kanata	かなた
haruki	はるき
toshitaka	トシタカ
katsuragi	桂木
yukiyanagi	ゆきやなぎ
negi	ねぎ
rensansan	れんさんさん
yuna	ゆな
tencho	てんちょ
mimineko	ミミネコ
akutarou	あく太郎
nozomi	のぞみ
goriton	ゴリトン
kihashi	木橋
rittooto	りっとーと
yuwa	ゆわ
piano	ぴあの
yasha	やしゃ
onifude	おにふで
uricha	うりちゃ
raru	らる
amino	網ノ
miyo	みよ
gachapin	ガチャピン
natsumi	ナツミ
akito	あきと
noratan	のらたん
kamo	かも
nemyusuke	ねみゅすけ
mayata	マヤタ
eko	えこ
tomotaro	ともたろ
tomo	とも
kikussan	きくっさん
norimaki	ﾉﾘﾏｷ
sasanokame	ささのかめ
kuwaharu	くわはる
sagaruya	さがるや
kotone	琴音
yuon	ゆおん
ami	あみ
kuro	黒
ume	うめ
gyohan	ぎょはん
katsumi	かつみ
taira	たいら
kurouri	くろうり
uesama	うえさま
shirokabocha	白カボチャ
gumi	ぐみ
namachako	なまちゃこ
tenjin	天神
sepi	せぴ
mikoto	ミコト
bachi	バチ
haruna	榛名
kotsubunomame	小粒の豆
mamazame	ままざめ
teriyaki	てりやき
riko	ﾘｺ
seiya	せいや
saboten	さぼてん
yukawa	湯川
samokou	さもこう
masora	まそら
namio	なみお
muramasa	むらまさ
hogepiyo	ほげぴよ
nipi	にぴ
manon	まのん
miren	みれん
kagura	かぐら
kagura	かぐら
sankeneko	さんけねこ
aramika	あらみか
yamada	山田
sagaruya	さがるや
hinamon	ひなもん
nonmofu	のんもふ
hogehogesan	ほげほげさん
nekona	ねこな
paruparumomochi	ぱるぱるももち
kurage	くらげ
doemu	どえむ
botchan	ボッちゃん
isana	イサナ
mayozame	まよざめ
tanuki	たぬき
dozuhiko	どずひこ
sarami	さらみ
rauporuku	ラウポルク
hinase	雛瀬
maasa	まあさ
massan	まっさん
inu	いぬ
koppepan	コッペパン
makimichi	まきみち
domio	どみお
takasehideo	高瀬英夫
shizukachan	しずかちゃん
kume	くめ
yato	やと
dare	誰
giriyaku	ギリヤク
matsuko	まつこ
kirikawa	霧川
riri	りり
ankokupegasasu	暗黒ぺがさす
ryou	瞭
ayugoro	アユゴロ
miho	みほ
niwatori	ニワトリ
yoiyami	よいやみ
yaya	やや
muu	むう
doimaru	どいまる
yuari	ゆあり
nobuseri	ノブセリ
iwata	いわた
kitaakari	きたあかり
hachipochi	はちぽち
nintaku	にんたく
saya	さや
kaede	カヱデ
umekonbu	梅こんぶ
giriyaku	ギリヤク
moe	もえ
haivu	ハイヴ
akari	あかり
nanashiteyan	ななしてゃん
tochiotome	とちおとめ
koumei	こうめい
natsui	夏井
usashiruku	うさしるく
gorochan	ゴロちゃん
furuhiro	ふるひろ
sokuremi	ソクれみ
hanitamago	歯にたまご
nobitan	のびたん
kiko	キコ
kisaba	きさば
gashi	がし
byakko	白虎
terari	テラリ
mimipan	みみぱん
kokko	コッコ
kukkiimonsutaa	くっきーもんすたー
yusuraume	ユスラウメ
maririn	まりりん
iroha	いろは
odachamame	おだちゃ豆
tsubaki	椿
nono	のの
aozora	あおぞら
kuromu	クロム
hidamarikun	ひだまりくん
ogata	おがた
manon	まのん
kachi	かち
takapi	たかぴ
mikado	帝
kumatoto	くまとと
mabosan	まぼさん
bunkura	ブンクラ
misakatomoya	御坂朋也
imajinneo	イマジンネオ
manotake	まのたけ
mio	みお
suzuemon	すずえもん
ema	えま
befumemu	べふめむ
manami	まなみ
rarirurero	らりるれろ
satsuki	さつき
sasanokame	ささのかめ
ukasa	うかさ
sagaru	さがる
takumama	たくまま
piiyomi	ぴいよみ
kamesan	カメさん
kanmaru	かんまる
yomogi	よもぎ
ishigu	イシグ
nikan	にかん
misaki	みさき
sae	さえ
emizebu	えみぜぶ
gunmaimai	ぐんまいまい
an	あん
nayuta	なゆた
mamachan	ママチャン
mo	も
toki	とき
inunabe	犬鍋
banana	ばなな
kamikire	かみきれ
bongeron	ぼんげろん
yutapon	ゆたぽん
gureifia	グレイフィア
ishiitomoya	石井智也
mikeke	みけけ
namachan	なまちゃん
oyatsu	おやつ
koumei	こうめい
ninomai	二の舞
youhei	葉柄
miyarimaya	みやりまや
tama	たま
hazuki	葉月
misumaru	みすまる
kasabuta	かさぶた
monachin	もなちん
eru	エル
yuri	ゆり
reomarua	れおまるあ
kisa	キサ
takamisa	たかみさ
rurito	るりと
sandaabaado	さんだーばーど
sora	ソラ
rikan	りかん
yura	ゆら
robita	ロビタ
hisui	ひすい
shifo	しふぉ
norako	のらこ
kei	ケイ
kenji	けんじ
rinkoro	りんころ
demekuro	でめくろ
abobo	あぼぼ
pesodoragon	ペソドラゴン
kantora	カントラ
kisaichi	キサイチ
hamichi	ハミチ
rira	リラ
gomachan	ゴマちゃん
yukimaro	ゆきまろ
mayajifu	まやじふ
miari	ミアリ
ruka	ルカ
riri	りり
miyaneyafan	ミヤネ屋ファン
kaminari	かみなり
ekurea	えくれあ
yae	八重
yumuse	ゆむせ
mizuhotaru	水蛍
ruanchan	ルアンちゃん
teria	テリア
nagi	なぎ
aonomusubi	蒼乃むすび
himagami	ひまがみ
aniruu	兄ルー
ran	らん
nama	なま
kuraku	くらく
tokichika	ときちか
kotani	小谷
mu	無
souka	そうか
yuuma	ゆうま
isson	いっそん
kaname	かなめ
zonu	ぞぬ
anri	アンリ
dede	でで
sakupan	さくぱん
kotoko	古都子
konaame	こな飴
osuzu	おすず
sumire	スミレ
hobikurou	ホビクロウ
reru	れる
rai	らい
amazake	アマザケ
kobochii	こぼちー
rio	リオ
shimizu	しみず
hiro	ひろ
sakaji	さかじ
harukaze	ハルカゼ
kuma	くま
haruume	ハルウメ
mimi	みみ
atsushi	アツシ
aburaage	あぶらあげ
kiyoka	キヨカ
hanauta	はなうた
souto	壮斗
tenito	てにと
haruiru	はるいる
onioni	おにおに
hiryuu	緋流
hazakura	葉桜
mamachan	ママチャン
magochin	まごちん
uminomozuo	うみのモズオ
rii	りぃ
usagi	ウサギ
yamiterasu	ヤミテラス
tetsuo	てつお
takase	高瀬
ririan	りりあん
yuuri	ゆーり
misoni	味噌煮
usagi	ウサギ
hide	ひで
marika	まりか
yukimi	ゆきみ
hirawata	ひらわた
fusuma	ふすま
hiro	ひろ
shokora	ショコラ
popura	ぽぷら
hiiragi	柊
miku	ミク
mikarin	美香りん
yaakun	やーくん
satoppe	さとっぺ
manakaa	まなかあ
maki	まき
toropen	とろぺん
ameri	アメリ
nakatsukuniaki	なかつくにあき
nifu	にふ
sayaendou	さやえんどう
mimimi	みみみ
shion	しおん
otakusa	おたくさ
isoppe	いそっぺ
yumaru	ゆまる
masaharu	まさはる
chinako	ちなこ
mosurusa	もするさ
debusaikusaitou	デブサイク斎藤
hidebu	ひでぶ
yuugiri	ゆうぎり
senmei	仙明
kaede	かえで
ginnashi	銀梨
yuki	雪
mika	ミカ
yaa	やー
chichika	チチカ
yasai	やさい
akuku	あくく
kumimo	くみも
ranran	らんらん
youka	ようか
fuyuichigo	ふゆいちご
ranran	蘭らん
momochi	ももち
taroutanaka	太郎田中
natsuno	夏乃
chakipon	チャキポン
eishin	エイシン
haruka	遥
abuchi	あぶち
wakame	わかメ
kisaragi	如月
shirone	しろね
rupi	るぴ
bunyashi	ぶにゃし
ramuken	らむけん
nyansan	にゃんさん
mayo	まよ
kaya	カヤ
wasabi	山葵
tsukaemon	つかえもん
hanashimoyuki	花霜ゆき
ruriwo	ルリヲ
iso	いそ
sona	そな
yamikan	やみかん
reddoburu	レッドブル
mayoko	マヨ子
akimi	アキミ
misuzu	みすず
roeru	ロエル
katsun	かつん
hinano	ひなの
nemimi	ねみみ
ri	り
karinosuke	カリノスケ
mia	みあ
okayamamakoto	岡山誠
hifumi	ひふみ
youkaasan	ようかあさん
nae	萎え
sou	そう
miyoshi	三好
ayataka	綾鷹
konpe	こんぺ
shu	しゅ
raisuku	ライスク
torikago	鳥かご
kotoko	古都子
hiryupon	ひりゅぽん
momo	もも
kurokami	クロカミ
raiden	雷電
sakurabiamane	さくらびあまね
setokazuki	瀬戸和樹
pachu	ぱちゅ
yoshi	よし
sumire	すみれ
uimamakawaii	ういままｶﾜｲｲ
imomochi	いももち
sahanaya	さはなや
gachirin	がちりん
shouyu	しょうゆ
renjaruderuman	レンジャルデルマン
beniya	ベニヤ
naoko	なおこ
sugitamoai	杉田モアイ
arinko	ありんこ
kukku	ｸｯｸ
remisaku	れみさく
emirun	えみるん
yujimiya	ユジミヤ
hanadamushi	花田虫
yama	やま
mi	み
ruda	ルダ
narimaru	なりまる
jorako	じょらこ
kotonogi	コトノギ
karekoro	カレコロ
konoyu	このゆ
nekopochi	ねこぽち
zakkorin	ざっこりん
ayabonosuke	あやぼのすけ
kotaroki	こたろき
nanayuki	ななゆき
nekota	ねこた
soroisoroi	ソロイソロイ
tarako	たらこ
fuuraibou	風来坊
rokuyongo	ロクヨンゴ
enma	えんま
riyu	リユ
otoha	おとは
koppyan	こっぴゃん
takeuchishinobu	竹内しのぶ
kantora	カントラ
emi	えみ
taihei	たいへい
kagari	カガリ
nozomi	ノゾミ
houkifuji	伯耆富士
arakidonsan	あらきどんさん
onoinafu	小野イナフ
saotaku	サオタク
ketoru	けとる
ai	あい
manyun	マニュン
howakabi	ほわかび
sunagokoro	砂ゴコロ
harumin	ハルミン
jako	じゃこ
abukuma	阿武隈
yashiro	やシロ
nosuke	ノスケ
nobita	のびた
nodayo	のだよ
sakura	桜
hokoita	ほこいた
yukko	ゆっこ
uyu	ぅゅ
okirakuoyaji	お気楽おやじ
yuno	ゆの
hongerion	ほんげりおん
zeusu	ゼウス
ayumu	あゆむ
toneta	とねた
hiryuu	緋流
papaia	パパイア
tsukasa	つかさ
monokuro	モノクロ
kairosukirari	カイロスキラリ
kitanami	きたなみ
kuro	くろ
runa	るな
niboshi	にぼし
hiryuu	緋流
imizu	いみず
shibusawa	シブサワ
satorin	さとりん
kotorisako	ことりさこ
tsugumi	つぐみ
kabii	かびぃ
yoshikun	よしくん
yuiren	ゆいれん
doku	ドク
garyoutensei	ガリョウテンセイ
yasha	やしゃ
kannazuki	神無月
namu	なむ
kugiko	釘子
tatemusu	たてむす
pepe	ぺぺ
yuyu	ゆゆ
reinre	レインレ
aro	あろ
sanmaime	さんまいめ
shibagori	しばごり
gahaha	がはは
horimo	ほりも
eito	エイト
ramu	らむ
moritaka	もりたか
ryuma	りゅま
chiemaru	ちえまる
mukaiya	むかいや
maruinu	まる犬
tonbo	とんぼ
ruri	ルリ
haruyama	はるやま
miyakotto	みやこっと
norakuroneko	野良黒猫
zokoira	ぞこいら
enoki	えのき
remoranosuke	れもら乃輔
masami	まさみ
nachi	なち
takase	高瀬
senuma	瀬沼
tonari	となり
kudoyo	くどよ
doraemon	ドラえもん
seiya	セイヤ
izumi	泉
kamisama	神さま
piyori	ぴより
hisato	ヒサト
aeka	あえか
nekonokuronben	猫のくろんべん
imotapi	いもたぴ
anzui	あんずい
udoppi	うどっぴ
enpi	えんぴ
akikaze	秋風
kana	かな
muhino	むひの
akiemon	あきえもん
shiokazeojisan	しおかぜおじさん
chunchunmaru	ちゅんちゅん丸
sako	サコ
iintefu	いいんてふ
nanamon	ななもん
gomama	ごまま
shibutomo	しぶとも
komi	こみ
mamachan	ママチャン
inako	いなこ
uhyu	うひゅ
iruka	いるか
ibukiaoi	いぶきあおい
tsukuyomi	ツクヨミ
rikuto	りくと
miyun	みゆん
mei	めい
ruruna	るるな
tomo	とも
kurumi	くるみ
terote	てろて
takehigo	竹ひご
uomura	ウオムラ
marukan	まるかん
haseramuda	ハセラムダ
tanien	たにえん
sahara	さはら
amamizu	雨水
omamu	おまむ
naoki	なおき
maniwakoumori	真庭蝙蝠
ikegamin	池上ん
sararu	さらる
reiki	レイキ
rokui	ろくい
moyu	もゆ
nakun	なくん
noniha	のには
tomoe	朋絵
yakkuru	やっくる
takakage	隆景
ariisan	アリイさん
sakuradango	さくらだんご
yukiyanagi	ゆきやなぎ
ponsuke	ぽんすけ
hebimemo	へびめも
seika	せいか
momoo	ももー
shimari	しまり
pio	ぴお
dozounonyaka	土蔵のにゃか
moyu	もゆ
asappo	アサッポ
ayato	綾斗
yokoku	よこく
arakidonsan	あらきどんさん
tobizaru	とびざる
engawa	えんがわ
fubukimaiko	吹雪舞子
nunrinu	ぬんりぬ
takimaru	瀧丸
shigatake	シガタケ
puriguru	ぷりぐる
maruro	マルロ
purinoko	ぷりのこ
akano	赤ノ
massoumen	まっそうめん
hondashi	ほんだし
kiruhara	キルハラ
yanagibuson	ヤナギブソン
moko	もこ
harunonanohana	はるのなのはな
miruko	みるこ
toshi	トシ
tomioka	とみおか
reppuu	烈風
morubitto	もるビット
suiren	スイレン
rumi	るみ
ichi	イチ
rikazou	りかぞう
yuyu	ゆゆ
ishitani	いしたに
kanon	かのん
ichihiko	壱ひこ
ruru	ルル
kumano	熊野
idekun	いでくん
marumaru	丸々
inu	いぬ
nekotasoso	ねこたそそ
renta	れんた
pokeaya	ポケあや
nannan	なんなん
kumi	久美
arakidonsan	あらきどんさん
notata	のたた
gomamugicha	ごまむぎちゃ
erumoa	えるもあ
toro	トロ
minmin	みんみん
yuyu	ゆゆ
rakko	ラッコ
maria	マリア
ayaka	あやか
aohebipokon	あおへびぽこん
nanoma	なのま
hanasaki	はなさき
mizuki	水樹
bozu	ぼず
motteketei	もってけ亭
gumi	ぐみ
tsubasa	ツバサ
mita	ミタ
yosaku	ヨサク
hazuki	はづき
hanasukijiisan	花好きじいさん
wasanuki	わさぬき
ruu	るう
ametorin	アメトリン
nasubidon	なすびどん
kiridarukyan	きりだるきゃん
yozakura	夜桜
mari	マリ
poshikemaru	ぽしけまる
piyo	ぴよ
ishira	石羅
suiren	睡蓮
mishimakazuya	ミシマカズヤ
pusan	ぷさん
toonokanako	遠野かな子
haruka	遥
satsumaimo	さつまいも
tamachan	たまちゃん
boushi	帽子
yozotaso	よぞたそ
kujira	くじら
kayori	かより
konchan	こんちゃん
asahi	朝陽
tsubasa	ツバサ
doyamona	どやモナ
miuka	みうか
misosazai	みそさざい
tsubasa	つばさ
ringo	りんご
pekinchan	北京ちゃん
tamago	卵
urako	うらこ
susugi	すすぎ
yukiyama	ゆきやま
hyouru	ひょうる
momoshiki	ももしき
taretarepanda	たれたれパンダ
nobe	のべ
miyuna	みゆな
suisei	彗星
ramuken	らむけん
tenmei	てんめい
hiro	ひろ
aochin	あおちん
takuri	たくり
kamisama	神様
kokumaro	こくまろ
yuu	ゆう
taidatadaaki	たいだただあき
chizuku	ちずく
kamekichi	かめきち
fujimonfujiemon	ふじもんふじエもん
dairinin	代理人
tonsuke	とんすけ
saikoro	さいころ
setoyan	せとやん
yoru	よる
saeki	冴木
hiraokarieko	平岡里枝子
pochi	ぽち
kazuma	かずま
namunamutora	ナムナムトラ
taiyaki	たいやき
kaoringo	かおりんご
haru	はる
tsuyoshi	つよし
nagi	なぎ
sakuragoma	さくらごま
mita	みた
tsuchi	つち
non	のん
katana	かたな
pottosu	ぽっとす
namazunomono	ナマズの者
toneunga	利根運河
moyashi	もやし
iorisan	庵さん
chise	ちせ
toneunga	利根運河
taso	たそ
bunsanbai	分散媒
shiro	しろ
noa	のあ
mikata	みかた
ara	あら
natsukisatoshi	夏樹聡
mina	みな
toranpu	とらんぷ
dokayama	ドカ山
takuno	たくの
emo	エモ
tokiya	トキヤ
namidabokuro	涙ぼくろ
wawo	わを
hina	ヒナ
takosukobayashi	タコス小林
tsuukun	つーくん
tomozou	ともぞう
harukanari	はるかなり
yuuna	ゆーな
mizu	みづ
yoshihito	よしひと
merereto	めれれと
yamiyami	ヤミヤミ
mogitate	もぎたて
setsu	せつ
nogupon	のぐぽん
niyaniya	にやにや
nojimatakeo	野島たけお
inumatori	いぬまとり
tarotan	たろたん
akagi	赤城
mugushi	むぐ氏
nandokamuro	なんどかむろ
mokkan	もっかん
kirari	きらり
higeneko	ひげ猫
azu	あず
yanase	ヤナセ
yakoukoudan	夜行講談
yuu	ユウ
manase	まなせ
surume	するめ
potetoo	ぽてとぉ
rasuniru	らすにる
marina	まりな
meru	める
yuno	ゆの
kage	かげ
chiko	ちこ
nasubi	なすび
jobooji	じょぼおじ
kensuou	けんすおう
pirun	ピルン
dokudami	どくだみ
oyatsuhime	おやつ姫
bu	ぶ
maya	まや
bea	べあ
pasukun	ぱすくん
kensuou	けんすおう
miso	味噌
ameko	アメ子
echiko	えちこ
sakiika	さきいか
aine	あいね
surume	するめ
shingo	しんご
monaka	ﾓﾅｶ
ringo	りんご
sakura	さくら
mugen	夢幻
nyamahamu	にゃまはむ
yoshiken	よしけん
umataisa	馬大佐
isojin	イソジン
toaru	とある
maron	まろん
makaron	まかろン
da	だ
kanayuki	かなゆき
rinokun	りのくん
hisoka	ひそか
kuroyasu	くろやす
shirokumamo	しろくまも
hio	ひお
sakaki	榊
kihana	ｷﾊﾅ
asamoshi	あさもし
furuido	古井戸
hitomi	ひとみ
sakiika	さきいか
sakurapon	さくらぽん
sarara	さらら
ika	いか
sukesan	スケさん
karuruu	かるるぅ
piero	ピエロ
nanashi	ななし
asashiba	朝柴
torisawa	鳥沢
gaon	ガオン
penne	ペンネ
yaneuranoneko	屋根裏の猫
dezaren	デザレン
taromaru	タロマル
sayaka	さやか
acha	あちゃ
yuimama	ゆいママ
nepugia	ネプギア
re	れ
yukiaka	雪赤
gomadare	ごまだれ
sokokawa	底川
hakubi	はくび
fugashi	ふがし
matsuda	松田
hakata	はかた
kudaya	クダヤ
uno	うの
morino	もりの
momose	百瀬
maron	まろん
sora	空
dozuhiko	どずひこ
kaeruiwa	カエル岩
yabuhebiko	薮へび子
amaou	あまおう
ayu	あゆ
penpen	ぺんぺん
kunaiuri	くない瓜
kuo	クオ
fuyoshin	ふょしん
ayasemami	綾瀬まみ
yuuyakun	ゆーやくん
haru	ハル
torisawa	鳥沢
reiju	れいじゅ
miraru	みらる
zzuzu	ッズズ
zuboradou	ずぼら堂
ranko	ランコ
yuu	ゆう
goma	ごま
sabo	さぼ
kan	かん
inashiro	いなしろ
mayua	まゆあ
sekken	せっけん
suzumarimaruko	すずまりまるこ
sodachi	育ち
hayawo	はやを
arara	あらら
nazu	なず
ibikineko	鼾猫
riomatsu	りおまつ
nuika	ぬいか
harukuma	はるくま
toritorin	トリトリン
midorikun	みどりくん
miyamai	みやまぃ
chikiu	ちきう
tsumezozo	つめぞぞ
samansa	サマンサ
kengo	ケンゴ
kenpirou	けんぴろう
souma	相馬
kumo	雲
mamemi	まめみ
hidaka	ヒダカ
nuika	ぬいか
inoneko	いのねこ
tosaka	とさか
unnohideyuki	うんのひでゆき
renka	れんか
souzai	そうざい
yukikaze	ゆきかぜ
guntose	ぐんとせ
kaibashira	かいばしら
naki	なき
motomichi	元道
yoshiki	よしき
kinomin	きのみん
taichange	タイちゃんげ
mimiuran	みみウラン
bibiriaruaru	ビビりあるある
yukihiko	ゆきひこ
tararira	たらりら
fumoru	ふもる
sakata	坂田
nyamin	にゃみん
miurameigen	みうら名言
fuwakunomama	不惑のママ
babuko	ばぶ子
hideki	ひでき
aoko	あおこ
michisachipapa	みちさちパパ
kiyohiro	キヨヒロ
hakofugu	ハコフグ
itasuke	イタスケ
murasakiiroi	むらさきいろい
todofurai	とどフライ
yuukimaru	ゆうきまる
seya	瀬谷
tonchan	とんちゃん
puni	ぷに
nagabana	ナガバナ
akaaka	赤赤
uniko	うにこ
kouchapanda	紅茶ぱんだ
matsukiyo	まつきよ
bunisuke	ぶにすけ
hosson	ホッソン
raion	らいおん
kosakura	こさくら
yuuta	ゆうた
roube	ろうべ
kotorisan	小鳥さん
hijiri	聖
tsurumyon	つるみょん
zono	ぞの
hiroto	ヒロト
akihiro	あきひろ
zeroro	ぜろろ
dokanmania	ドカンマニア
mamikichi	まみきち
akemi	明美
mamiru	まみる
tomoharu	ともはる
urako	うらこ
ichijou	一条
rean	レアン
kazuma	かずま
pechitan	ぺちたん
miyasa	みやさ
kannya	かんにゃ
yuuta	ゆうた
asayan	あさやん
mizusorairo	水空色
airi	あいり
manamin	まなみん
mamonotsu	まものつ
aohoshi	あおほし
nishikawa	にしかわ
aga	あが
akinosora	秋野ソラ
deko	でこ
shinji	伸二
haijingou	俳人号
shiro	シロ
satomin	さとみん
miiyu	みーゆ
ikatako	いかたこ
mutsumirira	睦りら
nyan	にゃん
kojika	こじか
hirorin	ひろりん
tamae	たまえ
kototan	ことたん
himi	ひみ
yoshitaka	よしたか
koukikeitopapa	こうきけいとパパ
noritama	のりたま
yururi	ゆるり
teuteu	てうてう
yumemakura	夢まくら
mitochon	みとちょん
saba	鯖
garururou	ガルル郎
atama	あたま
matsunoumi	まつのうみ
ryou	凌
yuyupiyo	ゆゆぴよ
kurotori	クロトリ
itarobo	いたろぼ
kinachoku	きなちょく
kanikama	蟹蒲
puni	ぷに
nanikonogazou	なにこの画像
suzuki	すずき
kiyobei	きよべい
ebichiri	えびちり
yakonoudon	やこのうどん
raika	ライカ
makochan	まこちゃん
herusakon	ヘル左近
usako	うさこ
uta	ウタ
yukkuri	ゆっくり
natsunon	なつのん
yuno	ゆの
kiri	キリ
gaiza	がいざ
niura	ﾆｳﾗ
saitouhiro	さいとうひろ
moguzou	もぐぞう
rairai	らいらい
piyomurasaki	ぴよむらさき
yamaringo	やまりんご
oharu	おはる
namiya	なみや
takawossan	たかをっさん
kika	キカ
reina	玲奈
saku	さく
ito	伊都
koukikeitopapa	こうきけいとパパ
kiki	キキ
katsuo	かつお
tentekomai	てんてこまぃ
ojigesan	おじげさん
sakusaku	さくさく
onichichama	おにちちゃま
sarasa	さらさ
nagase	長瀬
omatsu	お松
iriyuki	いりゆき
adachi	あだち
kirinyan	きりにゃん
uraneko	裏猫
yomogi	よもぎ
yamaringo	やまりんご
yosshi	よっし
michisachipapa	みちさちパパ
danmitsu	壇蜜
yon	ヨン
suzunotakahisa	スズノタカヒサ
rua	るぁ
hashineko	ハシネコ
torusutoi	トルストイ
myaako	みゃーこ
okusuridou	おくすり堂
nisezatsugaku	ニセ雑学
shinya	しんや
tsukigumi	つきぐみ
ayana	あやな
kuromori	黒森
nameyasu	なめやす
gezumakiba	げずまきば
ootamakoto	太田誠
izaya	いざや
nyaomasa	にゃおまさ
kamimuraerika	神村エリカ
aki	あき
sasachi	ささち
rihochiru	りほちる
aikata	相方
monchi	もんち
rereriri	れれりり
misagosan	ミサゴさん
maho	真帆
aninonia	豈乃ニア
seikai	青海
mikan	みかん
shousei	小生
hitomi	ひとみ
mikuru	みくる
ishirini	いしりに
hiru	ひる
oomura	大村
mikadosakura	御門桜
doramichan	ドラミちゃん
hamukogou	はむこ号
konkito	こんきと
aburaeoyaji	油絵オヤジ
reokun	レオくん
takataka	たかたか
urashimatarou	浦島タロウ
masumi	ますみ
tatsuya	たつや
iku	いく
happachan	はっぱちゃん
yatohomu	やとほむ
gomentosu	ごめんとす
eko	えこ
toori	トーリ
michisachipapa	みちさちパパ
kazekoga	かぜこが
karuyamakaruru	かる山かるる
nikimaru	にきまる
papabusa	パパブサ
sakuragikazuma	サクラギカズマ
takuya	たくや
kenji	けんじ
kiyowa	キヨワ
minu	みぬ
purimo	プリモ
mitsu	みつ
kajibo	かじぼ
takataka	たかたか
kei	けい
satori	さとり
muku	ムク
yukihiko	ゆきひこ
shinome	篠目
momotasan	もも田さん
reokun	レオくん
yotsubarai	四葉来
kerotan	ケロたん
puricha	ぷりちゃ
monaka	もなか
kiki	キキ
doramichan	ドラミちゃん
tobutetsu	とぶてつ
miyuki	美雪
yamada	やまだ
soranoiro	そらのいろ
ryun	りゅん
karozzo	カロッゾ
nyanta	にゃんた
juri	じゅり
naito	ナイト
azuna	あずな
kaito	魁斗
junjun	じゅんじゅん
dorayaki	どらやき
shirotama	しろたま
mirai	未来
komu	こむ
midorime	緑芽
kokoro	こころ
japa	じゃぱ
mikako	みかこ
shiichan	しいちゃん
suzu	スズ
muu	むう
datsumouhakusho	脱毛白書
sesuna	せすな
runa	ルナ
yamada	山田
hiro	ひろ
hemu	へむ
koko	ここ
riyu	りゆ
hozumitaruho	穂積足穂
kayashimaeiichi	萱島映一
wadachiya	轍屋
ameame	飴飴
honmarunisshi	本丸日誌
kiyobei	きよべい
sakakura	さかくら
yanmo	やんも
muusan	むーさん
rare	られ
ten	てん
miyazaemon	宮座衛門
taniryo	たにりょ
para	ぱら
mayata	マヤタ
satoran	さとらん
mare	まれ
miyuemon	みゆえもん
taone	タオネ
suzuki	すずき
upepo	うぺぽ
raika	らいか
mimi	ミミ
uni	うに
roberobe	ロベロベ
shion	紫苑
fujimune	ふじむね
kokui	こくい
nemu	ねむ
rokuchan	ろくちゃん
matsushin	まつしん
unanananananagi	うななななななぎ
hotamin	ホタみん
hinageshi	雛夏至
riria	りりあ
torapon	とらぽん
hayato	はやと
chonsu	ちょんす
kekkai	結界
kana	かな
kamicha	かみちゃ
yomi	よみ
yamaneko	やまねこ
sakupan	さくぱん
dairiten	代理店
sutato	すたと
chibimitsu	ちびみつ
setsuga	セツガ
samidare	五月雨
hikapote	ひかぽて
kusege	くせげ
asarin	あさりん
hakumai	白米
daizu	大豆
dassoujieitai	脱走自衛隊
sakurura	さくるら
pororumaki	ポロルマキ
takami	たかみ
hanetani	はねたに
shigewo	しげを
hirose	ひろせ
teketoko	てけとこ
kaname	かなめ
miki	みき
nayuse	なゆせ
meru	める
hitchan	ひっちゃん
mameena	豆えな
kuki	くき
ibajiji	イバジジ
saenaisuugakuto	冴えない数学徒
seiran	晴嵐
maru	まる
toarun	とあるん
nyanta	にゃんた
patariro	パタリロ
ran	ラン
topusu	とぷす
usaka	うさか
eriko	エリ子
matsunabi	まつなび
oudon	おうどん
inukaiohagi	いぬかいおはぎ
izayoi	十六夜
kairoshi	回路師
yuna	ユナ
goinkyo	ご隠居
shunki	しゅんき
cha	ちゃ
pokoten	ぽこ天
haniwa	はにわ
saburin	サブリン
yaku	やく
yuuutsutenshi	憂鬱天使
sukaparada	すかぱらだ
ta	た
natsuyama	なつやま
yuukun	ゆうくん
konucha	こぬちゃ
muei	むえい
tenorimike	手乗りミケ
aochin	あおちん
burita	ぶり太
rika	りか
yuhayu	ゆはゆ
shinobu	シノブ
sakimori	さきもり
ren	れん
aki	あき
mayurudou	まゆる堂
takasemano	たかせまの
mamonotsu	まものつ
kekkai	結界
ryocha	りょちゃ
ozu	オズ
toku	とく
gen	げん
yuyumurasaki	ユユムラサキ
atsuage	あつあげ
hitsu	ひつ
neyorika	ねよりか
senchan	せんちゃん
mon	もん
kurosakimanbou	黒咲まんぼう
tagawakatsumi	田川克巳
kuromaro	くろまろ
take	たけ
nobi	のび
hoshiumi	ほしうみ
temo	テモ
enoki	えのき
hyakuson	ひゃくそん
onoinafu	小野イナフ
macho	まちょ
sakana	さかな
tama	たま
kerakera	けらけら
kiichi	きいち
momo	桃
asunyan	あすにゃん
araraki	あららき
doremi	ドレミ
akonyan	あこにゃん
ronekosa	ろねこさ
etsuran	えつらん
wasabino	わさびの
take	たけ
mei	芽依
mafuyu	まふゆ
yamamoto	やまもと
asashiossan	朝潮っさん
moche	もちぇ
karaage	からあげ
yuru	ゆる
kuekue	くえくえ
pikapika	ぴかぴか
sora	ソラ
kanzakishun	神崎瞬
naya	ナヤ
amatsuba	あまつば
kuroyuri	クロユリ
non	のん
sakana	さかな
hanafusa	はなふさ
shagami	しゃがみ
komorebi	こもれび
haichuu	はいちゅう
akikaze	あきかぜ
yamaneko	やまねこ
hirunikurai	ひるにくらい
akasatana	あかさたな
kurara	くらら
taiyake	たいやけ
tantan	たんたん
yuru	ゆる
kiyobei	きよべい
mameena	豆えな
shinbunbuinsaku	新聞部員サク
kapisuke	かぴすけ
nasuo	なすお
umanari	うまなり
tomatozerii	トマトゼリー
shinbunbuinsaku	新聞部員サク
rikasan	りかさん
kurayoko	くらよこ
sakaji	さかじ
kiridarukyan	きりだるきゃん
yumeka	夢架
kongu	コング
shamojikaze	しゃもじかぜ
aroa	アロア
tsubasa	つばさ
dobamu	ドバム
noji	のじ
maria	まりぁ
tensou	てんそう
nekonyanma	猫にゃんま
kayuki	かゆき
amu	あむ
akamiyanozaki	赤宮ノザキ
taorusugisaku	タオル杉作
kenyu	けんゆ
ishikawa	石川
fasuzabu	ふぁすざぶ
kinokonotake	きのこの竹
ookumaneko	大熊ネコ
reizu	レイズ
itsuka	いつか
usagineko	うさぎねこ
noraneko	野良猫
okita	おきた
omarugou	おまる号
miyochi	みよち
miya	みや
yokoyan	よこやん
yuu	悠
umanari	うまなり
shimotsuke	しもつけ
miya	みや
jugon	じゅごん
nangokukajitsu	南国果実
shio	しお
yunoawa	湯のあわ
nekonomiiko	猫のミー子
yukitouko	ユキトウコ
mizukiri	ミズキリ
rena	れな
sasami	ささみ
fujitahiroyuki	藤田浩之
daruton	ダルトン
shio	しお
ririko	りりこ
masumasu	ますます
osebasu	おせばす
kana	かな
ogurin	おぐりん
kotatsu	こたつ
kokui	こくい
kani	かに
misaki	みさき
pakunofu	ぱくのふ
risamama	リサママ
kazeninaritai	風になりたい
shiguren	しぐれん
otoko	おと子
megumi	メグミ
mitsuhiko	みつひこ
shibakou	シバコウ
poikatsu	ポイ活
harukichi	ハル吉
mimihamuko	みみはむこ
sui	酔
shiina	しいな
zakishin	ざきしん
sakura	櫻
mashutaro	ましゅたろ
yoshinari	よしなり
koko	ここ
mariorima	まりおりま
mofu	もふ
mizudako	みずだこ
ouji	王子
tsunetan	ツネタン
ruri	瑠璃
reonarudo	レオナルド
tou	塔
chima	ちま
tontonsan	とんとんサン
nao	なお
kika	キカ
matcha	抹茶
tontonsan	とんとんサン
makoto	真琴
peperon	ぺぺろん
taiya	たいや
harusuke	はるすけ
oga	おが
kano	かの
popipepu	ぽぴぺぷ
yuran	ゆらん
yamagatatsubaki	山形つばき
urara	ウララ
kaatan	カータン
chaguma	チャグマ
arazome	あらぞめ
haru	ハル
roa	ロア
isan	イサン
berunchan	ベルンちゃん
kapibara	カピバラ
agetako	あげたこ
niyu	にゆ
kohaku	こはく
kazu	かず
aki	あき
oishiiocha	おいしいお茶
nekonoizumi	猫の泉
yokko	よっこ
shishieri	獅子えり
miiko	みぃこ
reiki	レイキ
satori	さとり
aotsuki	あおつき
risa	りさ
akko	あっこ
sara	さら
hayashi	林
raiko	ライコ
yamamin	やまみん
amanoguchi	アマノグチ
oga	おが
harunba	はるんば
kamiyo	かみよ
kamesan	カメさん
mito	みと
hyoroko	ヒョロコ
ayapoko	あやぽこ
nayu	なゆ
hijiki	ひじき
nontan	のんたん
matamatasaburou	又々三郎
imoten	いもてん
powanie	ポワニエ
kanekoneko	かねこねこ
miyuu	みゆう
akane	あかね
kotori	ことり
yumenofune	夢の船
agoten	あごてん
umi	うみ
eku	えく
saga	嵯峨
hidepumi	ヒデプミ
kanamon	かなモン
mimi	みみ
sabamiso	サバミソ
senami	瀬波
azuki	あずき
marumo	まるも
kihara	キハラ
hitotose	ヒトトセ
chiamo	ちあも
yuki	ゆき
tadachan	ただちゃん
neo	ねお
sasanokame	ささのかめ
yururan	ゆるらん
towachimu	とわちむ
homuchin	ほむちん
makiho	牧歩
usapika	うさピカ
konbu	こんぶ
budou	ぶどう
piroshiki	ぴろしき
takuto	タクト
orin	おりん
ken	けん
memi	めみ
umiyuri	うみゆり
koumosu	こうもす
yotsuba	よつば
shobon	しょぼん
aochiin	あおちぃん
yau	やう
chii	ちー
kino	キノ
kazu	かず
yoshitaka	義孝
bangou	番号
mizuki	みずき
ren	れん
kyakkan	きゃっかん
moyu	もゆ
hinata	ひなた
kabechoro	かべちょろ
saoman	さおまん
takanyan	たかニャン
noa	のあ
shiroha	しろは
itsuki	いつき
ranchan	ランちゃん
shirainu	しらいぬ
rika	リカ
nagaimo	ながいも
porarin	ぽらりん
kureno	クレノ
fana	ファナ
hekipeki	へきぺき
nyoroki	にょろき
daraneko	だらネコ
sai	さい
kyaraboku	きゃらぼく
sucharaka	すちゃらか
reirin	れいりん
rukusu	るくす
aki	アキ
yutsukiasami	ゆつきあさみ
yuri	ゆり
sayu	さゆ
takayuki	たかゆき
shou	ショウ
yuyuko	ゆゆこ
manekineko	まねきねこ
sabo	さぼ
hikaru	ひかる
masao	まさお
kanose	かのせ
yoyoto	よよと
geeno	ゲーノ
ura	うら
usami	うさみ
nopi	のぴ
ramuken	らむけん
akita	あき太
yuka	ゆか
yoshikawa	ヨシカワ
kitakura	北倉
ameameko	あめあめこ
renri	れんり
mokorin	もこりん
noza	のざ
usami	うさみ
fukuaki	福あき
matsuhaya	まつはや
shigure	時雨
sonchan	そんちゃん
onigamitora	おにがみとら
wozatomo	ヲザトモ
ayanamihei	綾波ヘイ
missan	みっさん
murasakiiroi	むらさきいろい
banri	バンリ
chikimaru	ちきまる
namuru	なむる
korua	コルア
yon	よん
yuki	ゆき
tomoe	朋絵
konbu	こんぶ
annosuke	あんのすけ
kobachi	小鉢
umu	うむ
kazamineko	風見猫
soraran	そららん
karen	珈憐
saorin	さおリン
iro	いロ
dentou	電灯
itokei	いとけい
an	あん
isana	いさな
hina	ひな
gyaodayo	ぎゃおだよ
itokichi	いときち
soraran	そららん
sakuranyan	さくらにゃん
sagannishiogi	サガン西荻
iori	いおり
makoto	まこと
mika	ミカ
ponchin	ぽんちん
ruyu	るゆ
otsuru	おつる
itou	伊藤
happa	はっぱ
zuo	ずお
soraran	そららん
kurono	くろの
mirano	みらの
fuetakishi	フエタキシ
nino	ニノ
nukotsumuri	ぬこつむり
saratoramama	サラトラママ
shinogu	しのぐ
koorogi	コオロギ
amagi	あまぎ
takanagikaya	たかなぎかや
sakipeka	先ペカ
hitomi	ひとみ
ringonoame	りんごの雨
chie	ちえ
kon	こん
yuzu	ゆず
umi	ウミ
yunno	ゆんの
osugi	おすぎ
mitasanta	ミタ三タ
morimura	もりむら
hanauta	はなうた
suna	すな
ten	てん
marumori	丸森
kaji	カジ
teto	てと
mikemaneki	三毛招き
rumi	ルミ
kyon	きょん
jun	じゅん
osuimono	お吸い物
eisou	えぃそう
hakurikiko	薄力粉
iwakugi	イワクギ
kazunoko	数の子
gururin	ぐるりん
hokuro	ほくろ
kureha	くれは
mirano	みらの
mujikun	むじくん
zatta	雑多
takara	たから
torihiki	取引
pekopon	ペコポン
zakuromochi	ざくろもち
nanashin	ナナシン
nyantako	にゃんたこ
okano	おかの
shintaro	しんたろ
akko	あっこ
etchin	えっちん
orikun	おりくん
kumagai	クマガイ
poyopoyochan	ぽよぽよちゃん
nui	ぬい
shikao	鹿緒
torihiki	取引
nomikke	のみっけ
mana	まな
kaki	柿
peso	ぺそ
sora	そら
piyo	ぴよ
michiko	みちこ
reita	れいた
ruruberu	ルルベル
merisu	メリス
hayama	葉山
miyuu	みゆう
fujiharu	ふじはる
utano	歌野
yuukichi	ゆう吉
kyoizumi	キョイズミ
kakeru	かける
makiharamakio	牧原まきお
hinachapi	ひなちゃぴ
fukuhanchi	ふくはんち
fujikai	フジ貝
kirin	きりん
yuu	ゆう
korokorokurumi	ころころくるみ
hokuro	ほくろ
morisan	森さん
chiro	ちろ
sonata	ソナタ
rin	りん
harukana	遥かな
emu	えむ
aro	あろ
hakumai	はくまい
tomatochan	とまとちゃん
itoyoukan	糸ようかん
akkarin	あっかりん
kakka	かっか
komazabesu	コマザベス
kidotami	きどたみ
megasaki	メガサキ
maikun	マイ君
masakuni	まさくに
risa	りさ
yuki	雪
takuya	たくや
miya	ミヤ
kawauso	川うそ
gata	ガタ
ishiatama	いしあたま
nisshi	にっし
saku	さく
uenshi	ウエンシ
pino	ぴの
sagadai	さがだい
shiranotaki	しらのたき
mameko	まめこ
mai	まい
numaken	ぬまけん
yusa	遊佐
ramune	ラムネ
tako	たこ
nata	なた
kinokino	きのきの
terayan	テラヤン
nyankoro	にゃんころ
kobayuri	こばゆり
jokin	じょきん
kotora	ことら
chimura	ちむら
mio	みお
masakuni	まさくに
kunaya	くなや
mutta	むった
haribon	ハリボン
mabotaso	まぼたそ
yumie	ゆみえ
sakaki	榊
mochi	もち
aipeta	あいぺた
amimin	あみみん
yudoufu	湯豆腐
dekao	デカオ
nonomaru	ののまる
nirainotsuki	二ライノツキ
okamo	おかも
ran	らん
iamatau	イアマタウ
zuma	ずま
nagisa	渚
haruto	ハルト
harukai	春改
kuma	くま
asaka	あさか
sakachotsu	さかちょつ
aohime	蒼姫
yuzuyu	ゆずゆ
rou	楼
takuto	タクト
tsumiki	つみき
yurugon	ゆるゴン
tamagosando	たまごさんど
takuan	たくあん
riki	リキ
toubun	とうぶん
yone	よね
norakuroneko	野良黒猫
kusabi	楔
kumipiyo	くみぴよ
matsuko	まつこ
chinatsu	チナツ
raora	らおら
chunta	ちゅんた
sesokone	セソコネ
tamamizu	玉水
pengirin	ぺんぎりん
mebaru	めばる
amemiyapito	雨宮ぴと
koushipon	こうしぽん
soraba	そらば
same	さめ
sakuramomo	さくらもも
aoyuyu	あおゆゆ
pikimaki	ピキマキ
richinosan	りちのさん
toyami	トヤミ
pin	ぴん
nezumimochi	ねずみもち
chisaki	ちさき
toubun	糖分
bakimaru	ばきまる
raira	らいら
azu	あず
miso	みそ
riko	りこ
chiu	ちう
akizuki	秋月
riku	りく
shirokuma	しろくま
yukuno	ユクノ
norimonobakari	のりものばかり
setora	セトラ
kiara	きあら
okase	オカセ
tani	たに
rumu	ルム
hiyoshi	ひよし
ramusayu	らむさゆ
torafugu	とらふぐ
noa	のあ
kaguro	かぐろ
kozou	こぞう
akaban	あかばん
rai	らい
shokimaru	しょき丸
tookage	とぉかげ
yanetsubomi	屋根つぼみ
karakurikarari	からくりからり
enri	えんり
yakiimo	やきいも
hikagerinaria	日陰りなりあ
churu	ちゅる
korodora	コロドラ
miho	みほ
seira	聖良
aizen	愛漸
tomomin	ともみん
misora	ミソラ
orichan	おりちゃん
gunso	ぐんそ
yode	よで
shinra	しんら
harutarou	はるたろう
bunbun	ぶんぶん
nakata	ナカタ
chiba	ちば
nyonchan	にょんちゃん
yunno	ゆんの
mi	み
aratahiro	あらたひろ
kasamatsu	かさまつ
soara	そあら
topio	とぴお
moina	もいな
towano	トワノ
mariya	まりや
suteusa	すてうさ
yuno	由野
kororo	コロロ
momyugirasu	モミュギラス
nagi	薙
rakubouzu	楽坊主
nyanyanya	にゃにゃにゃ
aimaru	あいまる
ramuu	らむぅ
daru	だる
makeneko	まけねこ
riki	リキ
neguse	ねぐせ
kakashi	かかし
ron	ロン
kotomiya	ことみや
roidohaido	ロイドハイド
sara	さら
aisan	愛さん
tanaka	たなか
sakurami	さくらみ
haruka	はるか
hatena	ハテナ
shirasu	しらす
mayu	まゆ
torijun	とりじゅん
mako	マコ
wakabaame	わかばあめ
raidaka	ライダカ
omurin	おむりん
murota	むろた
nite	にて
sanche	サンチェ
yuna	ゆな
sasami	ささみ
tamehiro	ためヒロ
miyano	ﾐﾔﾉ
akatsuki	あかつき
azarashi	アザラシ
burichika	ぶりちか
rakuto	らくと
takamizu	鷹水
rimuru	りむる
tanakyatsu	たなキャつ
makoto	まこと
umaaji	うまあじ
saki	さき
anzu	あんず
sei	菁
kurenomori	暮れの森
numachi	ぬまち
kanataman	かなたまん
gagyan	がぎゃん
suzushi	すずし
iwameme	いわめめ
hanyo	はにょ
mozu	もず
atsupiyo	あつぴよ
kaisoku	快速
ren	れん
tapitapi	タピタピ
ayu	あゆ
konchan	コンちゃん
yuriika	ゆりいか
hattorisankeiri	服部さん経理
nozubon	のずぼん
rii	りぃ
aoyami	蒼闇
kanorin	かのりん
momonoki	桃の木
nyanko	にゃんこ
mika	美香
ruichikameru	るいちかめる
isami	いさみ
soesan	そえさん
shirasu	しらす
soesan	そえさん
motoe	もとえ
yaisan	やいさん
kabara	カバラ
momenko	もめんこ
garaku	がらく
nekonohige	猫の髭
shiho	志穂
takumi	タクミ
akarin	あかりん
omochi	おもち
denan	でなん
naida	ないだ
neachin	ねあちん
risemia	リセミア
amu	あむ
hiro	ひろ
sakiringo	さきりんご
utsuwamono	うつわもの
hikicha	ひきちゃ
suekichi	末吉
nanameri	ななめり
samidare	さみだれ
shirokichi	しろ吉
idea	イデア
ohiimaru	おヒィ丸
yuuri	悠莉
non	のん
hamanii	はまにー
tonoroku	とのろく
yanahiko	やなひこ
montevi	モンテヴィ
kawako	河子
rukamaru	ルカまる
tsukasa	つかさ
batora	バトラ
owota	おをた
chiu	ちう
yomi	よみ
tanakyatsu	たなキャつ
sana	サナ
rouzato	ろうざと
mochiume	餅梅
anko	あんこ
mugi	ムギ
osugikunman	おすぎくんまん
watari	ワタリ
yuu	ゆぅ
nanasenana	ななせなな
asahi	あさひ
yozasuke	よざすけ
fumia	フミア
jun	じゅん
semihito	せみひと
deiku	デイク
hosuno	ほすの
tatsumihirowo	巽ヒロヲ
futon	ふとん
madoka	まどか
sumire	すみれ
yohira	よひら
kantaro	かんたろ
ohiyo	おひよ
fubuki	ふぶき
kirara	キララ
kumachan	くまちゃん
hyouga	ひょうが
noko	のこ
taniyan	たにやん
imaizumi	今泉
nishiguchi	西口
komeha	米派
makura	まくら
azusa	あずさ
inetanuki	稲狸
amadare	あまだれ
zaku	ざく
takepii	たけぴー
aruteba	あるてば
miyadon	みやどん
deji	デジ
maman	ままん
kugaouma	久我逢魔
katsura	桂
hirokin	ひろきん
haru	春
nagi	凪
suzuri	硯
erokuesuto	エロクエスト
yuuna	幽奈
rarikkusu	ラリックス
shibainunonta	柴犬のん太
hina	ひな
nekotama	猫たま
berukiman	ベルキマン
nagito	ナギト
nagima	ナギま
yamato	大和
chiichan	ちぃちゃん
urara	うらら
kakichi	牡蠣ち
homono	ほもの
omochi	おもち
runa	ルナ
youka	ようか
ame	あめ
fuwa	ふわ
ouenmu	応援む
tanaka	田中
sakanachan	さかなちゃん
kuyane	くやね
bugakun	ぶがくん
yadono	宿乃
amadare	あまだれ
peri	ペリ
aoi	葵
soraria	そらりあ
suga	スガ
gattsu	がっつ
akkoobachan	あっこおばちゃん
torikagonotori	とりかごのとり
monguri	もんぐり
yagisan	やぎさん
kinako	きなこ
nagi	なぎ
gaokaobasan	がおかおばさん
mashiro	ましろ
sakai	さかい
mizuki	みずき
mukachi	ムカチ
kurokan	黒艦
nemusuke	ねむすけ
mikan	みかん
karupisu	カルピス
nako	なこ
rifarua	りふぁるあ
kanato	かなと
ebiko	えび子
yoshino	ヨシノ
hakoranbo	はこらんぼ
soruto	ソルト
boyakenasu	ボヤケナス
kanajii	かなじー
hachimaru	はち丸
pensan	ペンさん
negima	ねぎま
neo	ネオ
ayako	あやこ
koyori	こより
rikio	りきお
ikanohito	いかのひと
kobayashi	小林
matcha	まっちゃ
sasa	ささ
poshikemaru	ぽしけまる
asayan	あさやん
toua	とうあ
pikanyan	ぴかにゃん
rin	リン
naishi	ナイシ
rei	レイ
hamachi	はまち
makotchan	まこっちゃん
dariko	だりコ
natsuhara	夏原
ranbato	らんばと
ikkun	いっくん
tontoma	とんとま
takenko	たけんこ
rina	りな
mono	もの
kokuyo	コクヨ
akacha	あかちゃ
kuroki	くろき
purioji	プリおじ
puapua	ぷあぷあ
epu	えぷ
hirousu	ひろうす
ringomaka	林檎まか
zen	全
rumi	るみ
eihara	えいはら
tsubasa	つばさ
mashimashi	ましまし
fajiarunyu	ふぁじあるにゅ
yuyuyu	ゆゆゆ
nadegata	なでがた
takaya	たかや
tomo	とも
chakirimakko	ちゃきりまっこ
omame	おまめ
magesuke	まげすけ
yaesakura	八重さくら
azuki	あずき
ato	アト
yume	ゆめ
nagibotan	凪牡丹
gou	ごう
shishieri	獅子えり
reimaru	れいまる
mirainikki	未来日記
ayato	ｱﾔﾄ
nagi	凪
tomoe	朋絵
kaori	香織
irohasan	いろはさん
oguri	オグリ
imuji	いむじ
hanahana	花はな
minatsu	ミナツ
sui	彗
warudo	わるど
tomuke	とむけ
aratomo	あらトモ
hiropon	ひろぽん
sakunon	さくのん
kurokawa	黒ｶﾜ
okoge	おこげ
tarosukesaku	たろすけさく
wachida	わちだ
ikurakundao	イクラくんだお
sakura	さくら
ron	ロン
sonnamonyo	そんなもんよ
reitan	れいたん
nasubimaru	なすび丸
iharu	いはる
nosukemaru	のすけまる
masa	マサ
chororisu	ちょろリス
kanoesaruya	カノエサルヤ
ea	エア
homi	ほみ
ten	てん
takumu	たくむ
yuunagi	悠凪
miyu	みゆ
yasumattechan	やすまってちゃん
chimako	ちま子
nayuho	なゆほ
nimo	ニモ
mea	めあ
dobuinu	どぶいぬ
hiroyukinosuke	ひろゆきのすけ
nasuko	那須子
kyounoekiben	きょうの駅弁
mohe	もへ
takumizumu	タクミズム
matcha	抹茶
sumibisan	炭火さん
nekofa	ねこふぁ
samidare	さみだれ
rousoku	蝋燭
bakanekonooyaji	バカネコのオヤジ
yorika	よりか
takanashi	タカナシ
kotobuki	ことぶき
charo	ちゃろ
tomo	とも
jupi	じゅぴ
yae	ゃぇ
michimi	みちみ
negitan	ねぎたん
ikaparari	いかぱらり
nomio	蚤尾
hamayumiya	破魔弓矢
saaya	さあや
koya	こや
matsuda	マツダ
papa	ぱぱ
hiruko	ひるこ
mugino	麦野
kabochan	かぼちゃん
aikoku	愛国
suzuki	すずき
masamei	まさめい
hiratsu	ひらつ
momoten	ももてん
shinkaimaruchi	深海マルチ
dedeneko	ででねこ
tsubasa	つばさ
genmu	幻夢
saitoumiko	斉藤みこ
youka	ようか
zemimen	ゼミメン
nukiero	ぬきえろ
ramu	らむ
waiwai	わいわい
yamaden	やまでん
tachibanatoshi	たちばな敏
hotaru	ほたる
minito	ミニト
bekkamu	べっかむ
mii	みい
ikurachan	いくらちゃん
shimijun	しみじゅん
mizutamari	みずたまり
ikurachan	いくらちゃん
harukanari	はるかなり
zanbai	ざんばい
makobe	まこべ
kiokio	きおきお
chimode	ちもで
mayataro	まやたろ
shin	シン
yakumoyukiya	矢雲雪弥
honobononinja	ほのぼの忍者
miyaran	みやらん
mimi	みみ
momoyuki	桃雪
akonen	あこねん
manamin	まなみん
uchiyaman	うちやマン
shinon	シノン
sahakuieru	サハクィエル
hamanasu	はまなす
naofumi	なおふみ
abareruebi	暴れるエビ
toshimi	としみ
norakuro	のらくろ
haru	はる
ito	糸
kijipoppo	きじぽっぽ
sarupengin	さるペンギン
yuiko	ゆいこ
kuwatomo	くわとも
nasubin	なすびん
nakkurin	ナックリン
yunomaru	ゆのまる
kannyan	かんにゃん
yomerunandoku	読める難読
negima	ねぎま
maasa	まあさ
kuzen	くぜん
chan	ちゃん
kogawawaki	コガワワキ
hase	はせ
ani	あに
saruton	さるとん
kawausomaru	川獺丸
toushirou	盗四郎
satsusatsu	さつさつ
uirou	ういろう
donapapa	どなぱぱ
shino	しの
nanakomama	ナナコママ
homokise	ホモ黄瀬
mitsuki	みつき
kudoyo	くどよ
kijipoppo	きじぽっぽ
oioi	おいおい
achan	あちゃん
suzuki	すずき
natsuki	なつき
moe	もえ
mamarin	ままりん
nanakomama	ナナコママ
yui	ゆい
koto	こと
meimeimei	メイメイメイ
rarirureiko	らりるれいこ
yuno	ゆの
satoru	サトル
shimeji	しめじ
muumuu	むーむー
hashimaisao	はしまいさお
karirin	カリリン
minato	みなと
sendaikamotsu	仙台貨物
kakuzu	カクズ
takuya	たくや
chibiruri	ちびルリ
okomeo	おこめお
suzuki	すずき
sankichi	さんきち
takoba	たこば
chunchichi	ちゅんちち
sasamon	ささもん
uzumemai	うずめまい
shiina	しいな
kankuro	かんくろ
tachiyure	たちゆれ
yumesuzume	夢すずめ
puuchan	プーちゃん
gifuaruaru	岐阜あるある
tamukei	たむケイ
namuru	なむる
hirorin	ひろりん
donadonae	どなどなえ
yoshia	よしあ
kagakueigo	化学英語
goriran	ゴリラン
poropo	ぽろぽ
momomeme	ももめめ
samasama	さまさま
hakomura	はこむら
yutapon	ゆたぽん
wataame	わたあめ
shimo	シモ
yamaen	やまえん
fujiko	フジコ
bote	ぼて
oppaipai	おっぱいぱい
haine	はいね
mashiroju	ましろじゅ
uryutan	うりゅたん
momo	桃
jaia	じゃいあ
shou	しょう
kuroyan	くろやん
rarudo	ラルド
nekuranomiko	根暗乃巫女
saganhakata	サガン博多
shoushin	昇進
rukaku	ルカク
panmaru	パン丸
kokoneri	ここねり
damayu	だまゆ
sanman	サンマン
michiwan	みちわん
karen	カレン
kuro	くろ
risokugatsuita	利息賀つい太
nimo	にも
inohige	イノヒゲ
rapi	らぴ
yamuyushi	やむゆし
kuniko	くにこ
yuu	ゆう
aharu	あはる
kirinamaki	きりなまき
nonno	のんの
ama	海人
panashima	ぱなしま
monao	もなお
piroma	ぴろま
mutsumi	むつみ
baumuroane	ばうむろ姉
maru	まる
uni	うに
sakuratouri	桜とうり
harukasu	ハルカス
ruisabu	ルイサブ
yamadori	やまどり
chatoraran	茶とら蘭
yasukun	やすくん
kasutaamu	かすたぁむ
marime	マリメ
yaki	弥紀
keishichou	警視庁
ibaraki	いばらき
kurokome	黒米
inorinokotoba	祈りの言葉
marochi	まろち
naki	なき
furotaki	フロタキ
yurabikun	ゆらびくん
hirohige	ひろひげ
bikke	びっけ
kuzuman	クズマン
harigahara	はりがはら
sadoku	サドク
nazu	なず
monogusa	ものぐさ
hirohige	ひろひげ
ruuji	るーじ
nipeira	ニペイラ
kou	こう
hatahata	はたはた
hijijikiki	ひじじきき
haruno	はるの
sawagani	サワガニ
menyawashiwa	麺屋わしわ
urawa	うらわ
meshineko	飯ねこ
yuu	ゆう
sara	沙羅
subarun	すばるん
kanna	かんな
ninneko	にんねこ
ringo	りんご
arua	あるあ
nanoka	ナノカ
chiijo	ちぃじょ
aosan	あおさん
saranchan	さらんちゃん
asuka	アスカ
apihapi	アピハピ
riko	莉子
mayokoro	まよころ
tomoko	ともこ
meisouoshirase	瞑想お知らせ
ajisai	紫陽花
hinamatsuriko	雛まつり子
sayozakura	紗夜桜
yana	やな
marimo	マリモ
mion	みおん
matsumo	まつも
shimaefu	しまえふ
nasuo	なすお
kuran	くらん
kaoruko	かおるこ
dekaihito	でかいひと
yuipoyo	ゆいぽよ
pepemaru	ぺぺ丸
tottoki	とっとき
moto	もと
isu	伊須
kibandasanzoku	黄ばんだ山賊
yugicha	ゆぎちゃ
kyare	きゃレ
himawari	ひまわり
piyoepi	ぴよえぴ
hiragishi	ひらぎし
amamizu	雨水
garumaruma	ガルマルマ
kouki	こうき
nogami	野上
mikko	みっこ
torihiki	とりひき
nishimasa	にしまさ
giyuichi	ぎゆ壱
kuroha	くろは
jincha	じんちゃ
magumarashi	まぐまらし
burikiya	ブリキ屋
usami	うさみ
marimo	マリモ
seguchi	瀬口
azu	あず
ikehon	いけほん
osa	オサ
akazukin	赤ずきん
kanaha	かなは
homugi	穂麦
satoko	さとこ
tsuchio	ツチオ
rekuro	れくろ
umeyukari	うめゆかり
bonta	ボンタ
wasa	和佐
kyon	キョン
ribon	リボン
yuya	ユヤ
osoba	お蕎麦
hakubi	はくび
akinosakura	秋乃桜
gorochan	ごろちゃん
koto	こと
oyapungin	おやぷんぎん
nijiiro	にじいろ
yuukire	ゆうきれ
chisako	ちさこ
karuki	カルキ
yuu	悠
cheri	ちぇり
yuyu	ゆゆ
hitoribakenbuin	ひとり馬券部員
yomechima	よめちま
kanayan	かなやん
tanutatsu	たぬたつ
poppo	ぽっぽ
ishiitakeru	いしいたける
kaaya	かぁや
hiro	ヒロ
mahoro	まほろ
tomo	とも
hitomi	ひとみ
nieppu	にえっぷ
doinakappe	ど田舎っぺ
hikosukea	彦すけあ
suuyatsu	吸うやつ
utao	うたお
nosuke	のすけ
tsurufukupikuwa	鶴福ピク和
keniyama	けに山
yudengabunomi	油田がぶ飲み
junchan	じゅんちゃん
koji	コジ
buchiko	ブチ子
kanan	華南
mi	み
maguro	まぐろ
gawa	ガワ
donsuke	どんすけ
hiyomi	ひよみ
nono	のの
hiroto	ヒロト
kika	きか
onigirionigiri	おにぎりおにぎり
hide	ひで
igichan	イギちゃん
non	ノン
indojin	いんどじん
morichan	もりちゃん
iyo	いよ
ankake	あんかけ
akihime	あきひめ
ohyon	おﾋｮﾝ
nozomi	のぞみ
ribere	りべれ
seri	せり
minemu	みねむ
haijima	はいじま
himawarin	ひまわりん
kurenai	くれない
noyuyu	のゆゆ
robosupeko	ロボすぺ子
marimo	マリモ
sayuyun	さゆゆん
iwatomo	いわとも
takurin	たくりん
asuka	アスカ
makumi	まくみ
kanako	かなこ
hitoku	非徳
takeo	武男
kaname	かなめ
machimo	まちも
sumikora	スミコラ
riseru	リセル
yukina	雪菜
nemochi	ねもち
oimo	おいも
chami	ちゃみ
hayachan	はやちゃん
ryuryuokaoka	りゅりゅオカオカ
aoidou	葵堂
hamone	はもね
suzuki	すずき
akaneko	あかねこ
pipitoro	ぴぴとろ
punio	ぷにお
harukanari	はるかなり
ayako	綾子
kimataharuzou	きまたはるぞう
yana	やな
kenshin	謙信
hanakuro	はなくろ
koha	こは
mameme	まめめ
asakami	あさかみ
naiman	ないまん
niina	にぃな
yukasan	ゆかさん
mimozamiho	みもざみほ
jagarin	じゃがりん
ichika	いちか
mokumaro	モクマロ
shino	しの
usui	碓氷
yugi	ユギ
mofu	もふ
aki	あき
richan	りちゃん
kaetoma	かえとま
shiroyu	しろゅ
kuma	くま
takashi	たかし
mitsuiatsushi	三井篤
karasuyama	からすやま
mamoru	まもる
wakura	わくら
chai	ちゃい
oniyanagi	おにやなぎ
minipa	みにぱ
sotokawamonako	ソトカワモナコ
kotatokoko	コタとココ
sakuya	さくや
rio	りお
ichimiya	イチミヤ
raita	らいた
hayasemegumi	早瀬めぐみ
rubetama	るべたま
rutoena	るとえな
ringo	りんご
seta	瀬田
nomikke	のみっけ
azuna	あずな
niwa	にわ
mokopon	もこぽん
akabane	アカバネ
kurowo	クロを
akio	あきお
usaginonekosan	うさぎのねこさん
chibibi	ちびび
kobayan	こばやん
sumire	すみれ
maron	まろん
yamada	やまだ
kagerou	陽炎
kobansuki	小判好き
inaba	因幡
ichika	いちか
mairan	舞蘭
unyauriko	うにゃうりこ
amayori	あまより
matsumo	まつも
moemama	もえママ
ayazukin	あやずきん
takanappo	たかなっぽ
satosato	サトサト
hinya	ひにゃ
saki	些紀
totoyukkuri	ととゆっくり
shun	しゅん
okamotokazuhiro	岡本一広
kanatatenma	彼方天馬
aaieba	ああいえば
itotaka	イトタカ
sayama	サヤマ
nikochan	にこちゃん
rimuru	リムル
inukai	犬飼
yamabukiginu	山吹ぎぬ
mofukawo	モフカヲ
omochi	おもち
aichun	あいちゅん
ouka	桜花
ayukorin	あゆこりん
yamiri	やみり
hiroto	ひろと
ikoan	いこあん
kashi	樫
abukumadaisuki	阿武隈大好き
hayasemegumi	早瀬めぐみ
dengerun	でんげるん
ai	あい
suzuki	鈴木
kunite	クニテ
kerochan	ケロちゃん
sousuke	荘介
ooen	おーえん
bakusoumaguro	爆走まぐろ
eri	えり
ma	ま
kuromaru	くろまる
hanaru	はなる
hana	はな
akarin	あかりん
bono	ボノ
maou	魔王
iiroku	いいろく
marochi	まろち
neru	ねる
sanapi	さなぴ
kitori	キトリ
daira	だいら
meitousaya	冥凍沙耶
petoke	ぺとけ
sanasuwa	さなすわ
anihatsu	アニはつ
hiikun	ひーくん
monendo	モネんど
matatabi	マタタビ
oganyan	おがにゃん
yuita	ゆいた
mikan	みかん
masacha	まさ茶
akamari	あかまり
toraneko	とらねこ
ringaberyu	凛ガべりゅ
satosato	サトサト
ayako	あやこ
sugainu	スガいぬ
yumi	ゆみ
usui	碓氷
gohan	ごはん
maria	まりあ
inumurakuniku	犬村狗肉
namo	なも
nao	ナオ
ameripippi	アメリぴっぴ
kuroma	くろま
sabamugi	鯖むぎ
takanappo	たかなっぽ
tomo	とも
hato	鳩
natsume	ナツメ
sakuta	さくた
mikeru	みける
odateru	オダテル
katsumi	かつみ
ume	うめ
urara	うらら
nyarutasu	にゃるたす
tenchan	てんちゃん
noukasseika	脳活性化
hakumaikun	白米君
miiru	みぃる
ouka	桜花
udonya	うどん屋
zoukin	ぞうきん
ishiitakaaki	石井孝明
suzukun	すずくん
ootan	おぉたん
kei	けい
hidekun	ひでくん
ryouya	リョウヤ
magu	まぐ
sawadawasa	沢田わさ
miiru	みぃる
arabiki	あらびき
maho	まほ
kirari	きらり
marorin	まろりん
shiichan	しーちゃん
hiyo	ひよ
fuji	ふじ
aonekomochi	あおねこもち
yuyu	ゆゆ
kenya	けんや
ami	あみ
maru	まる
hikaru	ひかる
futaba	双葉
koge	こげ
bunchan	ぶんちゃん
otanekun	おたねくん
omamegu	おまめぐ
hiyo	ひよ
yomo	ヨモ
megumi	めぐみ
nayu	なゆ
guutaraonna	ぐーたら女
kakikukeko	かきくけこ
asami	あさみ
yuka	ゆか
miyu	みゆ
kayama	カヤマ
nyachiita	にゃちーた
mizuho	みずほ
womusubi	をむすび
pirohiko	ピロ彦
haya	はや
enoki	えのき
tomizawa	とみざわ
minoru	ミノル
taka	たか
setoyan	せとやん
mumu	ムム
tomoichi	ともいち
hakase	はかせ
ogi	おぎ
okkun	おっくん
heroin	へろゐん
yoshichanman	よしちゃんまん
katsunori	かつのり
shikazumi	しかずみ
katefu	かてふ
mana	マナ
hiro	ひろ
kamikawanao	神河奈央
kyoutatsu	響辰
noshiika	のしいか
manamana	まなまな
mizusura	みずすら
arakawa	あらかわ
taka	たか
maonosabu	まおのさぶ
tsuruchan	つるちゃん
makinana	まきなな
anago	あなご
japa	じゃぱ
kito	きと
kouda	こうだ
misaka	ミサカ
kohaku	琥珀
sunaneko	すなねこ
usagitabako	兔タバ子
yuhi	ゆひ
kanchobi	かんちょび
mushimori	むしもり
hageruna	ハゲルナ
tamahima	たまひま
saori	さおり
saikare	さいかれ
nuta	ぬた
yumemi	夢見
abarabou	あばらぼぅ
doemu	どえむ
yubeshi	ゆべし
tomokio	ともきお
kinamon	きなもん
yuuki	ゆうき
mame	豆
chiriko	チリコ
ayori	あより
shisai	詞彩
shirowanko	しろわんこ
chuukokeisokuki	中古計測器
aoikitsune	あおいきつね
satou	佐藤
ikuyan	いくやん
pino	ぴの
momopi	ももぴ
nishiko	にしこ
chanmisa	ちゃんみさ
nyoraneko	ニョラネコ
mio	澪
toashima	とあしま
rei	れい
usami	うさみ
eseyadamon	似非やだもん
kirara	キララ
kii	きぃ
kyabetsu	キャベツ
kazuya	和哉
nyan	にゃん
andorori	あんどろり
yamazakigou	山崎号
hitomi	ヒトミ
sea	せあ
chataroo	ちゃたろー
dosukeberairai	どすけべらいらい
chun	ちゅん
yomi	よみ
chiine	ちぃね
yashinoki	やしのき
takara	たから
rui	るぃ
fuu	ふう
konako	こなこ
rinringo	りんりんご
beeko	べーこ
itsukisarasa	いつきさらさ
panikun	ぱにくん
amamori	雨森
harukario	はるかりお
taka	たか
sasakiraimu	佐々木来夢
asakero	あさケロ
hayate	はやて
soruto	そると
mogu	もぐ
noa	のあ
kano	かの
shirousaginyan	しろうさぎにゃん
miyutechi	みゆてち
kirinoorehana	霧野俺はな
senri	千里
unko	うんこ
okaki	おかき
shirokuma	しろくま
riona	りおな
asa	アサ
sakuranamasa	桜奈まさ
zawawa	ざわわ
manaka	まなか
fuwarichan	ふわりちゃん
erin	えりん
chii	ちい
yuchio	ゆちお
ayaka	あやか
noru	のる
ochabu	おちゃぶ
chinsukou	ちんすこう
miwato	みわと
aso	あそ
kirimaru	きり丸
zenji	ゼンジ
nei	ねい
kokkoyama	こっこ山
narikakun	なりかくん
nyororin	にょろりん
sakura	さくら
masao	まさお
kirisuma	キリスマ
ako	あこ
maki	槙
kurisu	クリス
cha	ちゃ
kokui	こくい
yukke	ゆっけ
yureme	ゆれめ
kaze	風
miso	みそ
yashiro	ヤシロ
maka	まか
monchi	もんち
sakusora	さくそら
oni	ｵﾆ
watanoai	わたのあい
noushoukomachi	脳漿小町
kuromame	くろまめ
kamonanban	鴨南蛮
chasu	ちゃす
amanojaku	あまのじゃく
yuzu	ゆず
kuppa	くっぱ
poritan	ポリたん
kureharu	くれはる
shagaru	シャガル
nanon	なのん
rutea	ルテア
tamaruhiroshi	田丸浩史
kojahebi	こじゃ蛇
nna	んな
neru	ネル
hiropon	ひろぽん
mao	まお
hannarimako	はんなりまこ
kiri	キリ
maguma	マグマ
manzokumanpuku	満足まんぷく
harukaze	春風
shino	篠
techi	てち
betarobo	べたろぼ
kazui	カズイ
buchiko	ブチ子
kawa	かわ
takemaru	たけまる
yunyun	ゆんゆん
magu	まぐ
maakun	まーくん
aai	ああい
yamadadeii	やまだでいい
keito	ケイト
iroha	いろは
tomohiro	ともひろ
minori	みのり
mamocha	まもちゃ
takoyaki	たこ焼
akkun	あっくん
chomi	ちょみ
miyuma	みゆま
kawakou	かわこう
mochimegane	もちメガネ
pafemaru	ぱふぇまる
mayu	繭
yutaeru	ゆたえる
ooruri	おおるり
arusu	アルス
shigeharuru	しげはるる
chika	ちか
toki	鴇
yuzu	ゆず
hehe	へへ
osushi	おすし
sakure	さくれ
yukine	ゆきね
kasouro	火葬炉
kani	カニ
konda	こんだ
mine	ミネ
yukito	ゆきと
rinka	りんか
chie	ちえ
aomi	あおみ
kengo	ケンゴ
amaasu	アマアス
nijiokasan	虹岡さん
mutsuhiyo	むつひよ
seiten	せいてん
koume	小梅
azuma	あずま
okaka	おかか
mokomoko	もこもこ
macha	まちゃ
okaratanto	オカラタント
shiso	しそ
yassu	ヤッス
kuromegane	黒めがね
penmaru	ペン丸
kanata	かなた
take	たけ
sayuki	さゆき
pipimi	ぴぴみ
hizuki	ヒヅキ
nekomaru	猫丸
awatami	あわたみ
sankichi	さんきち
kapiko	かぴこ
naruhodo	なるほど
purea	プレア
mukudori	むくどり
akari	あかり
kiki	きき
meijin	めいじん
naetoru	なえとる
hibyou	非病
tsukiyono	月夜野
hayashi	林
donrappi	ドンラッピ
merenge	めれんげ
igusa	いぐさ
shiichan	しーちゃん
uchishun	うちしゅん
on	穏
namikawa	ナミカワ
ritsu	リツ
babu	バブ
kabe	かべ
warewarai	われ笑
fuminanananana	ふみななななな
ranran	らんらん
ayanamihei	綾波ヘイ
yuna	ゆな
numachi	ぬまち
miku	みく
itotto	いとっと
achamaru	あちゃまる
asaka	アサカ
abekougyou	阿部工業
takecho	竹ちょ
jagaimo	じゃがいも
kiyomaru	きよまる
odawarahakone	オダワラハコネ
mucho	むちょ
maikkomaru	まいっこ丸
takecho	竹ちょ
guritoguraburu	ぐりとぐらぶる
mui	むい
kobayan	こばやん
kokedama	コケだま
amaasu	アマアス
akitora	あきとら
yakiniku	やきにく
etowaru	えとわる
rarara	ららら
katoru	カトル
kazu	かず
shu	しゅ
dosukoiman	どすこいまん
tokunao	とくなお
wara	わら
aichan	あいちゃん
rutea	ルテア
eiji	エイジ
sousakuinu	創作犬
nanaseniki	奈々瀬にき
suiro	水路
nagika	なぎか
gin	ぎん
tanakou	たなこぅ
kusena	くせな
hajimaru	端丸
sendaimoteta	仙台モテ太
tenta	てんた
shion	しおん
taro	たろ
hekutaru	へくたる
arerenren	あれれんれん
riri	りり
hikuina	ひくいな
hiibou	ひー坊
kyon	きょん
koguwa	こぐわ
saorin	さおリン
satone	さとね
shinchan	しんちゃん
mayu	繭
riri	りり
chiya	ちや
konpeki	コンペキ
satoru	サトル
kukiwakameyukki	くきわかめゆっき
saku	朔
shiso	しそ
wakamiya	わかみや
kaganorisu	カガノリス
momi	もみ
shirona	しろな
hodo	ほど
anko	あんこ
mugi	むぎ
mugi	むぎ
namekuji	蛞蝓
munieru	ムニエル
haruranman	春爛漫
mebae	めばえ
masaki	まさき
sakuradori	さくらどり
chiya	ちや
yata	ヤタ
mimi	みみ
miitan	みーたん
morikko	もりっこ
mumeko	むめこ
naofumi	なおふみ
oritou	おりとう
jidouhikki	自動筆記
kamokarasoba	かもからそば
hanitamago	歯にたまご
tsunamayo	つなまよ
kaguyamaru	かぐやまる
nuoo	ぬおー
sarutajira	さるタジラ
emi	えみ
komako	こまこ
napori	なぽり
shiroro	しろろ
harumaki	はるまき
taiki	たいき
nobehan	のべはん
kazeninaritai	風になりたい
reon	れおん
kokkoyama	こっこ山
kuzusharo	くずしゃろ
momote	ももて
batamon	バタモン
petekyouto	ペテ教徒
utamaro	うたまろ
kanno	かんの
fugashi	ふがし
chitose	ちとせ
yomi	ヨミ
shiro	白
himata	ひまた
aoneko	青猫
noguchimasami	野口雅美
eamaron	エアまろん
tomoya	智也
mochigai	モチガイ
yoshiki	よしき
karaage	からあげ
taizan	泰山
morichan	もりちゃん
kobayan	こばやん
techimon	てちもん
hitoku	非徳
hannarimako	はんなりまこ
misora	み空
unimomuumiushi	うにもむうみうし
ponta	ポン太
minara	ミナラ
honoka	ほのか
michiwo	みちを
kamekichi	かめきち
tomo	とも
usagiya	うさぎや
mofufu	もふふ
jaba	じゃば
oomori	大森
magunesu	マグネス
haruta	ハルタ
mirokaari	みろかあり
pokke	ぽっけ
itaru	いたる
tsukiyoumi	月夜海
taru	たる
sora	そら
hayashi	林
kira	きら
chami	ちゃみ
atomari	アトマリ
kotomo	ことも
kishinaoki	きしなおき
chachan	ちゃちゃん
cherimin	ちぇりみん
daichan	だいちゃん
miechin	みえちん
mikan	みかん
guyu	ぐゆ
minyaru	みにゃる
minto	みんと
mamiya	間宮
rakuto	らくと
ririkun	りりくん
takeoka	たけおか
riyo	りよ
kiki	キキ
natsu	なつ
shikaku	しかく
renachi	れなち
ringo	りんご
kuragari	くらがり
kukukeke	ククけけ
mitsumomo	蜜桃
maito	マイト
aocha	あおちゃ
somemoyou	そめもよう
nana	なな
junko	じゅん子
teru	てる
miyanagaharu	宮永ハル
kuraku	玖楽
aoneko	青猫
yasapen	やさぺん
itaru	いたる
femizemi	ふぇみゼミ
nna	んな
sakaki	榊
tokei	とけい
shihona	しほな
nuritakuru	塗りたくる
nyu	んゆ
yukawa	ユカワ
sakura	さくら
neririn	ねりりん
shikioka	志木岡
nami	ナミ
maako	まぁこ
mametta	まめった
kanikama	カニカマ
maru	まる
harui	春井
hinoaya	ひのあや
sora	そら
sanotsuki	さのつき
roa	ロア
kikunon	きくのん
hikaru	ひかる
sakua	さくあ
tokio	トキオ
ichijiku	無花果
kumochan	くもちゃん
ninosan	にのさん
shiina	しいな
suzuhi	スズヒ
daikonran	だいこんらん
yokako	よかこ
kakisuke	かきすけ
ryon	りょん
sora	そら
kinako	きなこ
eretto	えれっと
gon	ごん
umi	海
mochimugi	もちムギ
asutan	あすたん
teisui	艇酔
chororisu	ちょろリス
kome	こめ
mikageyuuhi	御影夕日
rearu	れある
naokki	なおっき
mino	ミノ
otoshimono	おとしもの
tomosankaku	ともさんかく
jinroku	ジンロク
ochako	おちゃこ
fuyoshin	ふょしん
tsuruki	つるき
odessa	オデッサ
uta	うた
puricha	ぷりちゃ
miyupo	みゆぽ
himechan	ひめちゃん
isuzu	いすず
sakatama	さかたま
rota	ろた
aincha	あいんちゃ
kunshi	くんし
shiroro	しろろ
taka	鷹
okara	おから
kyoro	きょろ
piyomame	ぴよ豆
nemumu	ねむむ
yunmin	ゆんみん
akatsuki	あかつき
usagiame	うさぎ飴
ayubosu	あゆぼす
aere	アエレ
hewachan	へわちゃん
hakataro	はかたろ
marirun	まりるん
achamo	あちゃも
fujiko	フジコ
minto	みんと
mamo	まも
tamachan	たまちゃん
renren	れんれん
mimizuku	みみずく
shiroshiba	しろしば
umiushi	うみうし
nada	ナダ
radauta	ラダウタ
kiyo	きよ
harumo	はるも
mohisu	もヒ須
kazuki	カズキ
reiya	れいや
shiatoro	しあとろ
kuma	くま
hakumai	白米
sekinko	せきんこ
hazuki	はづき
metappou	メタッポウ
mayata	マヤタ
yuyu	ゆゆ
hikina	ひきな
onakaitai	おなかいたい
daifuku	だいふく
haru	ハル
murakumo	ムラクモ
nishikakogawa	にしかこがわ
kobochii	こぼちー
kiseichan	規制ちゃん
fumisuke	ふみすけ
mugibatake	麦畑
sanada	真田
sora	そら
runo	るの
remi	れみ
mia	魅亜
okaki	おかき
ako	あこ
chiimama	ちーまま
yokkun	よっくん
inabaokimono	いなば置物
papiko	ぱぴこ
sasukezaemon	サスケざえもん
kaede	かえで
batchan	ばっちゃん
pyon	ぴょん
enon	えのん
hachirou	はちろう
tachikoma	タチコマ
nakahara	なかはら
karisa	かりさ
papiko	ぱぴこ
taihei	たいへい
negi	ねぎ
wasako	わさこ
yunamei	ユナメイ
kajuen	果樹園
papio	パピオ
rueru	ルエル
chage	ちゃげ
nao	なお
choko	チョコ
rena	れな
homaruchan	ほまるちゃん
karasu	カラス
tsuki	ツキ
minto	みんと
gurujin	ぐるじん
kasuyan	かすやん
hinata	ひなた
atsumin	あつみん
ruri	瑠璃
kuzukago	屑籠
furifurimomo	フリフリモモ
kingyo	金魚
abuzui	阿武瑞
rei	れい
rottoro	ろっとろ
chun	ちゅん
marunyan	まるにゃん
komatsuna	小松菜
kirimisakana	切身魚
purin	プリン
himepon	ヒメポン
taetae	たえたえ
kaito	かいと
yama	やま
soipon	そいぽん
nijiberu	にじべル
erika	エリカ
homuzuki	ほむずき
maru	マル
u	う
fumipon	ふみぽん
takurou	たくろう
chanmari	ちゃんまり
sorairo	ソラいろ
aisama	あい様
arugon	あるごん
torimaru	鳥丸
yosaku	よ作
yuki	雪
amurozumirei	アムロズミレイ
shun	しゅん
ume	うめ
kouta	こうた
moneidou	モネイドウ
daidai	だいだい
ponpoko	ぽんぽこ
obake	おばけ
oyun	おゆん
sasanagi	ささなぎ
ramune	ラムネ
tomokichi	ともきち
jizeruchan	じぜるちゃん
ao	あお
nekopekko	ねこぺっこ
hakuten	はく天
ayanon	あやのん
michiya	みちや
juri	じゅり
aoi	あおい
yamepi	やめぴ
aruko	あるこ
gumi	グミ
suraa	スラア
biwaomochi	びわおもち
shiori	しおり
yamaken	やまけん
horigotatsu	ほりごたつ
niseki	にせき
aokidekiseki	青黄でキセキ
mamegaracha	豆がら茶
miya	みや
yonyon	よんよん
isasa	いささ
majiwata	まじわた
ritonorun	りとのるん
omiju	おみじゅ
tomoppe	ともっぺ
ami	亜実
yun	ゆん
neeyan	ねぇゃん
nukaboko	ぬかぼこ
minomushi	みのむし
saewata	冴えわた
ishinanao	いしななお
koi	こい
usagiotoko	うさぎおとこ
kanoe	かのえ
suzunari	すずなり
notewa	のてわ
maki	マキ
yukikimu	ゆききむ
mai	まい
hinako	ひなこ
megadaibutsu	メガ大仏
koume	こうめ
hekisa	ヘキサ
papipu	ぱぴぷ
irori	囲炉裏
ferinowaki	フェリの脇
yuuryou	ゆうりょう
tonbo	とんぼ
para	ぱら
gogonotenkiame	午後の天氣雨
haru	はる
seto	せと
haineko	灰猫
akiakiaki	あきあきあき
okka	おっか
sumiya	スミヤ
nakomofu	なこもふ
yukemuri	ゆけむり
meru	める
hamunemaboru	はむねまぼる
omiju	おみじゅ
epo	えぽ
nukarume	ぬかるめ
tokage	とかげ
kuromu	くろむ
pupu	ぷぷ
hiroppi	ひろっぴ
aritayagi	ありたヤギ
ajipon	味ぽん
nekomata	ねこまた
miosame	澪鮫
kuromame	くろまめ
meimei	めいめい
anmanna	あんまんな
ottotto	おっとっと
nayuho	なゆほ
rorimero	ロリメロ
hiryouman	肥料マン
masa	まさ
kitaakari	きたあかり
arisaku	ありさく
moka	もか
taka	たか
haniwa	はにわ
mitsuki	みつき
mochippi	もちっぴ
fenia	ふぇにあ
nekotetan	猫手たん
kaneyan	かねやん
tsuchio	ツチオ
mememe	めめめ
umichan	うみちゃん
nogigino	のぎぎの
uen	うえん
taoru	たおる
seiyokumamire	性欲まみれ
tayu	たゆ
iroha	いろは
roripan	ろりぱん
mitarashi	みたらし
mutou	無糖
natsume	ナツメ
meme	めめ
pirorin	ピロりん
kika	キカ
kento	けんと
ibarausagi	茨兎
izayoi	十六夜
henohenomorita	へのへのもりた
kinnikun	きんに君
miten	みてん
yuuhiromu	ゆうひろむ
emi	えみ
oda	オダ
chiyarin	ちやりん
haruraku	はるらく
maihime	舞姫
chiba	ちば
rushiera	ルシエラ
katsudon	かつどん
oniisan	お兄さん
kukka	くっか
kaeruseijin	かえる星人
ajisai	あじさい
nekosennin	猫仙人
soa	ｿｱ
panorama	ぱのらま
totanpa	トタンパ
robomaru	ろぼ丸
mana	マナ
sudaashiya	須田葦也
saorin	さおりん
nami	なみ
machopi	まちょぴ
kisara	きさら
utsusemi	空蝉
hossan	ほっさん
akitaku	あきたく
yuukinoheya	ゆうきの部屋
gumimi	ぐみみ
aki	あき
gureifia	グレイフィア
natsupo	なつぽ
chibisawa	ちびさわ
koshaken	こしゃけん
rashin	らしん
sora	空
masuhiko	ますひこ
yuyu	ゆゆ
yureme	ゆれめ
taka	たか
kaon	かおん
miyakotto	みやこっと
sayuyun	さゆゆん
teruteru	てるてる
emimiura	エミミウラ
aaaa	ああああ
kanipasuta	かにぱすた
kuruton	くるとん
yuu	ユウ
myuui	みゅーい
min	みん
asato	朝斗
tsukumo	つくも
akita	あきた
oshida	押田
akutozen	悪ト善
izuku	いずく
kumiko	クミコ
ponyodora	ぽにょどら
bouningen	棒人間
hanashiawanai	はなしあわない
ichiru	いちる
mogumogukun	もぐもぐ君
kotobukiman	コトブキマン
sanso	酸素
yasapen	やさぺん
wataame	わたあめ
fuwafuwanokuma	ふわふわのくま
hanon	はのん
kimayun	きまゆん
uka	うか
karua	かるあ
sujiniku	すじにく
neo	ネオ
kichisuke	きちすけ
urawa	うらわ
hakutakagou	はくたか号
youseisan	妖精さん
urawazakun	裏技君
yonoki	よのき
subaru	昴
kanata	カナタ
kuro	クロ
yamazakimiho	やまざきみほ
hakuenfuki	白煙吹き
same	さめ
pisu	ぴす
aozora	青空
saku	さく
manoreo	マノレオ
nyakochi	にゃこち
barusu	ばるす
takahiro	タカヒロ
ame	あめ
yokochi	よこち
arai	アライ
non	のん
hiyayakko	ひややっこ
yuihan	ゆいはん
ikaokura	いかおくら
erina	えりな
mikomama	みこママ
furifurimomo	フリフリモモ
matsuru	まつる
maro	まろ
satsuki	さつき
fujisan	ふじさん
yodamomo	与田もも
sabaneko	鯖猫
aika	アイカ
repi	れぴ
miyatake	ミヤタケ
shinji	しんじ
yorori	よろり
zakkorin	ざっこりん
poko	ぽこ
kui	杭
fujijun	ふじじゅん
samidare	さみだれ
asapi	アサぴ
suzu	すず
zakuro	柘榴
fusu	ふす
yuzu	ゆず
naranoneko	奈良のねこ
nekotasu	ねこたす
fujisan	ふじさん
nana	なな
inano	いなの
hikage	ひかげ
vanvaiyoshioka	ヴァンヴァイ吉岡
sei	セイ
sayumi	さゆみ
ramune	らむね
nakabon	なかぼん
fumipon	ふみぽん
yoasobi	よあそび
hokoinu	ホコ戌
haruru	はるる
satoha	サトハ
jinseikudaranai	人生くだらない
homokise	ホモ黄瀬
kasanosuke	かさのすけ
marumiyakun	まるみやくん
omote	おもて
asamon	アサモン
ishi	いし
hanashiawanai	はなしあわない
heppoko	へっぽこ
yuzuha	ユズハ
inari	いなり
nobou	のぼう
gansobesshoman	がんそべっしょマン
shikimi	しきみ
amagi	天城
ikke	いっけ
nopufi	ノプふぃ
kuma	くま
azumine	あずみね
yukimushi	ゆきむし
sakuramochi	さくらもち
nan	なん
amatsuda	あまつだ
riopi	リオピ
hin	ひん
kai	かい
fukuha	ふくは
kikochan	きこちゃん
hoshinasu	ほしなす
masapyon	まさぴょん
nobuyumi	のぶゆみ
ako	あこ
sensen	せんせん
miya	みや
reito	玲斗
yato	ヤト
poyopoyochan	ぽよぽよちゃん
kokatorisu	コカトリス
amemaro	アメマロ
rizu	りず
chibu	チブ
nonchun	のんちゅん
kyontarou	きょんたろう
neko	ネコ
yukako	ユカコ
yukisan	ゆきさん
sukechasu	すけちゃす
iori	伊織
mun	むん
riri	りり
kanakeke	かなけけ
hatosabu	はとさぶ
miyabi	みやび
mashitonodesu	ましとのです
hassaku	はっさく
yato	やト
kopio	こぴお
sui	翠
nagomi	なごみ
suigin	水銀
kaijinshoukai	怪人商会
yawakonuiguru	やわこぬいぐる
ajiwai	あじわい
kozueyuki	梢友紀
shirikoba	しりこば
okikoebi	沖コエビ
ruri	瑠璃
onisan	おにさん
koro	ころ
gureifia	グレイフィア
ujiko	うじこ
kaitoma	かいとま
iikochi	いいこち
pirika	ぴりか
mimurokku	みむろっく
runa	ルナ
moru	もる
mutoumei	無透明
takamipo	タカミポ
nakato	なかと
ikekubo	いけくぼ
nabe	なべ
chimuran	ちむらん
joringo	じょりんご
yomosan	よもさん
yasaka	八坂
yokamo	よかも
yaabon	やぁぼん
moshamaru	もしゃ丸
gaako	がぁこ
awagome	あわごめ
shin	シン
antsubu	あんつぶ
touka	トウカ
mizu	ミズ
okaki	おかき
mamachari	ママチャリ
mika	ミカ
beyan	べやん
nagataku	ながたく
meibisu	メイビス
usui	碓氷
hinori	ひのり
kuu	くー
fuuko	ふぅこ
gochiame	ごちアメ
sando	さんど
chakochan	チャコちゃん
macha	まちゃ
miyahae	ﾐﾔﾊｴ
yuu	ゆう
maruno	まるの
mokusei	木星
ponyodora	ぽにょどら
nekomamirenoora	猫まみれのおら
nana	なな
maria	マリア
kosuke	こすけ
nemu	ねむ
roa	ろあ
fujinari	ふじなり
rogu	ログ
chirumasu	チルマス
sayumo	さゆも
mitori	みとり
sanasanasan	さなさなさん
gyotaku	魚拓
mizukishorin	みずき書林
penmaru	ペン丸
minarai	みならい
tonmii	とんみぃ
papiyon	ぱぴよん
michi	みち
midori	みどり
oyuisan	おゆイさん
uraken	うらけん
puke	ぷけ
chokusan	ちょくさん
yuzu	ゆず
kinpira	キンピラ
fumia	フミア
erika	えりか
sorano	そらの
rei	れい
eko	えこ
sakuraebi	桜えび
yura	ゆら
hanakokun	花子くん
sabuchan	さぶちゃん
osamura	オサムラ
mokona	モコナ
matsurinka	まつりんか
riri	りり
zouri	ゾウリ
mamegohan	豆御飯
wokome	ヲ米
toyuki	とゆき
natsuo	なつお
meacha	めあちゃ
kitagami	きたがみ
sanseberia	さんせべりあ
ruka	るか
koro	ころ
fukuchamu	フクチャム
tatsumi	たつみ
enokiman	えのきまん
sorata	空太
kantoku	監督
tontonsan	とんとんサン
nyantotosu	ニャントトス
junji	じゅんじ
hagatan	ハガたん
yozakura	夜桜
shinmaru	シン丸
yuipoyo	ゆいぽよ
takosu	タコス
kohaku	琥珀
katchan	かっちゃん
hironohiro	ヒロノヒロ
anemone	アネモネ
yoshirin	よしりん
takaya	タカヤ
yaako	やぁこ
torichan	鳥ちゃん
usapyon	うさぴょん
puke	ぷけ
ameko	あめこ
miyako	みやこ
nekoko	ネココ
saegusa	さえぐさ
yukikun	ゆきくん
miki	みき
same	さめ
raikou	らい公
shinshin	しんしん
pipiko	ぴぴこ
hiroko	ひろこ
yoshifumi	ヨシフミ
yuukajira	ゆーかじら
tensaiman	天才マン
erochiwa	えろちわ
poko	ぽこ
muchiko	むちこ
rokuha	ロクハ
fujisan	ふじさん
gattengou	ガッテン号
tomozou	ともぞう
asuwan	あすわん
wakami	ワカミ
shaketaro	シャケたろ
okome	お米
nanigashi	なにがし
shirogoto	しろごと
kuu	クウ
kanegon	かねごん
kazura	カズラ
ren	れん
noin	のいん
suzuyuki	鈴雪
bao	バオ
yushi	ゆし
shinshin	しんしん
mayaya	まやや
runyaani	るにゃあに
dannoura	だんのうら
mawo	まを
yuzuriha	ゆずりは
animearekore	アニメあれこれ
rakushun	楽俊
amano	あまの
tomozu	ともず
maiku	まいく
tadataku	ただたく
kanekotto	かねこっと
eringi	えりんぎ
kira	きら
nishikawakabosu	西川かぼす
shikipino	四季ぴの
marimon	まりもん
setsu	せつ
harumi	春美
demetan	デメタン
uzumaki	渦巻き
takutomu	たくとむ
yuipoyo	ゆいぽよ
nino	にの
koyunyu	こゆにゅ
miyahae	ﾐﾔﾊｴ
zutoyume	ずとゆめ
sakura	さくら
yukihyou	ユキヒョウ
hikaru	ヒカル
pipiko	ぴぴこ
eu	えう
usamomo	うさもも
richa	りちゃ
danmaru	だんまる
nakai	なかい
pipiko	ぴぴこ
amanokaguyama	あまのかぐやま
hosotareme	ホソタレメ
mirimo	みりも
komura	こむら
shiotori	塩鳥
akkun	あっくん
itanori	いたのり
akichan	あきちゃん
midorima	ミドリマ
marukan	マルカン
gonsuke	ごんすけ
iharu	いはる
saku	朔
uminosuke	うみのすけ
yopiyopi	よぴよぴ
ren	れん
ai	哀
zenri	善利
imo	いも
kiraranomama	きららのママ
ucha	うちゃ
masaki	マサキ
pigumon	ピグもん
yoshimune	ヨシムネ
nun	ぬん
sorairo	そらいろ
hoshiyu	ほしゆ
murasaki	むらさき
rino	りの
akane	アカネ
shiori	しおり
wasatefu	わさてふ
nagaremono	流れ者
sawahato	サワハト
amaoto	あまおと
yuki	ゆき
kuromame	くろまめ
moru	もる
yume	ゆめ
musessou	無節操
miruku	みるく
maonosabu	まおのさぶ
ranto	らんと
babuko	ばぶ子
kirara	キララ
nagi	なぎ
aki	あき
mizumoto	みずもと
pouko	ぽうこ
taishi	たいし
patano	ぱたの
harigahara	はりがはら
shirokuma	シロクマ
yuno	ゆの
chenzu	チェンズ
ibuki	いぶき
genbu	げんぶ
kobataku	こばたく
kenniko	ケンニコ
hakomura	はこむら
ayapan	あやぱん
miyaji	ミヤジ
maidosan	まいどさん
umu	うむ
onyasai	温野菜
ringo	林檎
emohichi	えもひち
hinanata	ひななた
pupipo	ぷぴぽ
goemon	ごえもん
koioyu	濃いお湯
run	るん
mashinomi	ましのみ
akanezora	あかねぞら
masukapi	マスカピ
goemon	ごえもん
noka	のか
seichakan	せいちゃかん
oyuya	お湯屋
miwao	みわお
nishitama	にしたま
osanu	おさヌ
rupi	るぴ
antei	あんてぃ
henchinsai	変珍齋
totora	ととら
minomaru	みのまる
natsui	夏井
nako	なこ
akuro	アクロ
komori	子守
guu	ぐぅ
nekonoizumi	猫の泉
masawo	まさを
dontenkekkou	曇天決行
masami	まさみ
masa	まさ
chomumama	ちょむまま
meideoro	めいでおろ
kaorura	カオルラ
shinshin	しんしん
menuwa	めぬわ
amisan	あみさん
kanaroa	カナロア
mikazuki	三日月
tadano	ただの
puya	ぷや
hatto	はっと
hinaheka	ひなへか
youhei	ヨウヘイ
mizudon	みずどん
senjoutarou	戦場太郎
kusunoki	楠
seaburanokami	セアブラノ神
pipiko	ぴぴこ
shirokuma	しろくま
shimotsuki	しもつき
kirayori	キラヨリ
nagi	なぎ
reicheru	れいちぇる
airi	あいり
hakase	はかせ
keizu	けいず
koruto	こると
mongo	モンゴ
ramuda	らむだ
mizuno	水野
arudaira	アルダイラ
ninasama	になさま
yamasan	やまさん
chisato	ちさと
fumiyapapa	ふみやパパ
takizawa	たきざわ
miyuki	美雪
yamiryuu	闇龍
mobo	モボ
kanna	かんな
anago	あなご
anzu	あんず
kanzaki	かんざき
giruru	ギルル
saruppii	さるっぴー
potoraru	ぽﾄらる
makopen	まこぺん
fukubiki	ふくびき
shiina	ｼｲﾅ
naribou	ナリボウ
sayamaru	鞘丸
potepu	ぽてぷ
fain	ファイン
tonno	トンノ
sou	ソウ
morikawa	森川
noruru	のるる
gumimi	ぐみみ
hagure	はぐれ
ako	あこ
tetsumirechan	鉄みれちゃん
yuyukuma	ゆゆくま
hisui	翡翠
shafumon	社不もん
pekuchin	ペクチン
sui	翠
masato	まさと
pokehenjin	ポケ変人
muku	ムク
mitasenaruaru	三田線あるある
hinataakira	ひなたあきら
nanako	ななこ
chopira	ちょぴら
moririn	もりりん
sayou	左様
pepoko	ぺぽこ
heramusu	ヘラムス
bou	坊
ojiji	おじじ
imaiku	いまいく
fuyuusagi	冬兎
ayu	あゆ
hiyo	ひよ
iikagennotsuki	イイカゲンノツキ
eisen	エイセン
paseri	パセリ
shirota	白た
isoginchaku	イソギンチャク
morisukoyaka	森すこやか
shiruku	しるく
tebasaki	てばさき
fushieda	フシエダ
toponyan	とぽにゃん
reso	れそ
nakaya	なかや
sharu	シャル
kyoutotetoteo	今日とてとてお
sakuramochi	さくらもち
ohagi	御萩
suzume	すずめ
hayoojisan	はよおじさん
gingasenki	銀河線記
masato	まさと
donguri	どんぐり
chaki	ちゃき
hiroma	ひろま
rumu	ルム
haruwarabe	はるわらべ
pokari	ポカリ
sayusayu	さゆさゆ
daikonion	ダイコニオン
tochikaokun	とちかおくん
hirori	ひろり
rapisu	ラピス
narisupi	なりすぴ
yamiterasu	ヤミテラス
ameno	アメノ
katatsu	かたつ
kawachan	川ちゃん
uesuginiguseu	うえすぎにぐせう
mutchan	むっちゃん
yayoi	やよい
mofujimanjuu	もふじ饅頭
tora	とら
yoko	よこ
sugito	スギト
yuuko	ゆうこ
taremasa	たれまさ
irohamu	いろはむ
banabana	ばなばな
mimarea	ﾐﾏﾚｱ
katatsu	かたつ
anatanomeido	貴方のメイド
kurofune	くろふね
kira	きら
mitame	見た目
oohiramasayoshi	大平正芳
chiru	ちる
miyaneyafan	ミヤネ屋ファン
wayachon	わやちょん
kagome	かごめ
sasanoha	笹乃葉
negitoro	ねぎとろ
okaka	おかか
riyokuchiya	りよくちや
mebiusu	メビウス
uyuyu	うゆゆ
agoshin	あごしん
zaraeru	ザラエル
ayame	あやめ
hyoukai	氷塊
ayuri	あゆり
muhyuru	むひゅる
yochinade	よちなで
hinichikako	ひにちかこ
hatomikan	はとみかん
fuji	フジ
ironono	いろのの
chibu	チブ
hijiki	ひじき
kusayan	くさやん
kumaneko	くま猫
mea	メア
shirokuma	しろくま
una	うな
nagomi	なごみ
nami	波
riran	莉蘭
kiri	桐
sakapi	さかピ
pepe	ぺぺ
sazanami	さざなみ
yuku	ゆく
sakurayama	さくらやま
kohaku	琥珀
riyu	りゆ
suiran	すいらん
nasuho	なすほ
konose	ｺﾉｾ
owanchan	おわんちゃん
igarashidai	五十嵐大
hachi	はち
fuyuusagi	冬兎
momoka	ももか
niko	にこ
doragonchan	どらごんちゃん
monmon	もんもん
mugi	むぎ
aki	あき
uyuri	うゆり
kumakuma	くまくま
yamigami	やみがみ
kikuchimegane	菊地眼鏡
mokepon	もけぽん
yuzu	ゆず
somosan	そもさん
meiko	めいこ
kattsun	かっつん
koru	こる
kominami	こみなみ
zaraeru	ザラエル
kudoyo	くどよ
yukimitsu	ゆきみつ
maitaro	まぃ汰ろ
shimari	しまり
kaya	かや
mau	まぅ
nayuta	那由多
homura	ほむら
meshi	めし
kuzuman	クズマン
natsu	なつ
soratobi	そらとび
ibuki	いぶき
fenia	ふぇにあ
kotoko	ことこ
mizunomori	水の森
hotate	ほたて
kumakano	くまかの
miairin	みあいりん
shobonmaru	しょぼんまる
peripatosu	ペリパトス
aki	アキ
sakamushi	さかむし
shoko	しょこ
akoya	あこや
konoha	このは
minikairotto	ミニカイロット
ikechan	池ちゃん
kuzuman	クズマン
pon	ポン
amugori	あむごり
sakura	さくら
saenaisuugakuto	冴えない数学徒
nao	なお
shizuku	雫
tomoichi	ともいち
maka	まか
yoshidatoro	吉田トロ
jin	じん
osuzu	おすず
harusame	はるさめ
mutsuki	むつき
raibuikitai	ライブ行きたい
yatsuha	やつは
asuware	アスワレ
osuzu	おすず
hachi	はち
sasami	ささみ
kurono	くろの
yutaka	豊
satoru	サトル
wakaba	わかば
monmachi	もんまち
shigepachi	シゲぱち
mayu	まゆ
nirauemon	にらうえもん
shikauma	しかうま
osakae	おさかえ
karu	かる
koto	こと
tomoe	ともえ
fukurami	ふくらみ
matatabi	またたび
shigure	時雨
urutorapapa	ウルトラパパ
takatsuki	高槻
shibuchin	しぶちん
ouka	桜花
ree	れー
kuniaki	くにあき
mainichimonchan	毎日モンちゃん
konose	ｺﾉｾ
ageha	アゲハ
nairon	ナイロン
yuzu	ゆず
fukazawachisato	深澤ちさと
tororo	とろろ
china	ちな
miru	ミル
dainosuke	だいのすけ
dorojiai	泥試合
yoshino	ヨシノ
damegane	駄メガネ
keppokutta	けっぽくった
sae	さえ
shigure	時雨
sumikiran	すみきらん
shou	しょう
ponta	ぽん太
ajun	亜潤
matsuitomato	松井トマト
nen	ねん
momokarin	ももかりん
eiji	エイジ
run	るん
shinshin	しんしん
higashinonono	東ののの
tsubuan	つぶあん
yukinohitohira	雪のひとひら
boa	ボァ
kei	けい
gumimi	ぐみみ
pana	ぱな
kusakarijuuji	草刈十字
yun	ゆん
kotarin	コタリン
nanana	ナナナ
mogamiemon	もがみえもん
inugami	犬神
hotaru	ホタル
okome	おこめ
megumichu	めぐみちゅ
aya	あや
muramasa	村正
hiro	ひろ
gattengou	ガッテン号
kumanara	くまなら
agoshin	あごしん
kanten	かんてん
gumimi	ぐみみ
hanahana	はなはな
kuniaki	くにあき
azuma	あずま
pikasan	ピカさん
peroko	ペロコ
toponyan	とぽにゃん
nonno	のんの
ebisen	えびせん
okiku	お菊
akira	あきら
kazu	カズ
takanori	たかのり
yomogi	よもぎ
kurokuma	くろくま
miyaran	みやらん
anmya	あんみゃ
haruchiyo	はるちよ
inukai	犬飼
suzuki	すずき
tenmachou	てんまちょう
naoi	なおい
manetoranooni	マネトラの鬼
re	レ
yaku	やく
yureru	揺れる
ai	あい
samu	さむ
katsuwo	カツヲ
fuki	ふき
riri	りり
mugibatake	麦畑
takashi	たかし
takasago	タカサゴ
nekoyanagi	猫柳
konchi	こんち
aya	あや
setsu	セツ
tororotokonbu	とろろとこんぶ
gyojin	ぎょじん
shibarou	しばろう
yukinohitohira	雪のひとひら
koto	こと
kaimani	かいまに
sekainokumapi	世界のくまぴ
kurosagi	くろさぎ
emyuu	えみゅー
mejiro	めじろ
karakoma	からこま
yuki	ゆき
mitsuba	みつば
kyomochi	きょもち
raira	ライラ
erii	エリー
sousakuinu	創作犬
maguro	マグロ
murasaki	むらさき
kasumi	かすみ
tatsuya	達也
kayochi	かよち
mikari	みかり
himari	ひまり
chiyoko	千代子
mujin	ムジン
tsunetan	ツネタン
nakoso	勿来
yoneko	よねこ
tobiuo	トビウオ
mami	まみ
abisu	アビス
suzuko	すずこ
rikito	りきと
petan	ぺたん
mion	みおん
re	レ
etsuran	えつらん
yukichi	ゆきち
kuraku	くらく
kopeemon	こぺえもん
asakami	あさかみ
touya	とうや
sanpuri	算プリ
akamaru	赤丸
mizunashireki	水無れき
popon	ぽぽん
hisabou	ひさぼう
raomu	ラオム
chiinamo	ちぃなも
yukito	雪斗
rozemaru	ろぜまる
tonoyama	とのやま
nanakusa	ななくさ
shironuko	しろぬこ
denden	でんでん
mitsuya	みつや
sakaki	さかき
soramiko	ソラミコ
hana	はな
odorena	おどれな
kohaku	琥珀
hagayui	はがゆい
kanyapi	かにゃぴ
tomoichi	ともいち
nanase	七瀬
takamaki	タカマキ
chachan	ちゃちゃん
asayan	あさやん
kuwataro	くわたろ
mii	みい
hirari	ひらり
masamipyon	まさみぴょん
ameri	あめり
ueiru	うえいる
makoyanra	まこやんら
kyouten	狂天
piyoko	ぴよこ
usaka	うさか
garururou	ガルル郎
datto	脱兎
emo	えも
anyopin	あんよピン
momon	ももん
shiaha	シアハ
ponke	ポンケ
gajua	がじゅあ
yassan	やっさん
sora	そら
konnyakugou	こんにゃく号
poyo	ぽょ
sayasuke	サヤスケ
rona	ろな
shitoreme	しとれめ
kaito	快斗
miroku	弥勒
jisonshin	自尊心
yuuka	ゆうか
kuroko	黒子
ree	れー
misaki	みさき
soato	そあと
yukari	ゆかり
sapi	さぴ
unipo	うにぽ
asondekun	あそんでくん
nukadoko	ぬかどこ
onburu	オンブル
misaya	ミサヤ
yuuri	ゆうり
nao	なお
ree	れー
tozamasan	とざまさん
kashiwa	かしわ
uranansakaba	ウラなん酒場
remu	れむ
domingo	ドミンゴ
hinamaru	ひなマル
narutae	なるたえ
piroru	ぴろる
kuroko	黒子
erena	えれな
mahiru	まひる
kama	かま
zaki	ザキ
asahi	朝飛
kamo	かも
moyashi	もや氏
purinsan	プリンさん
chikka	ちっか
kaworun	かをるん
surei	スレイ
sunaku	スナク
kako	かこ
tanukisoba	たぬきそば
niiko	ニイコ
nezutaso	ねずたそ
sazanami	さざなみ
shizuma	しずま
oama	おあま
serizawa	芹沢
miyuo	ミユオ
osobachan	おそばちゃん
kaatan	カータン
ayano	アヤノ
kurari	くらり
kiyuki	きゆき
norina	のりな
sayachan	さやちゃん
mattan	まったん
makoumu	マコウム
kaeru	かえる
ginji	ギンジ
momo	もも
yukimi	ゆきみ
oyun	おゆん
kiara	キアラ
yume	ユメ
sayaka	さやか
yukkurugaya	ゆっくるがや
aki	あき
yuma	ゆま
gahaha	がはは
soramame	そらマメ
bukiyouchan	不器用ちゃん
hibino	日々野
yuuto	悠斗
potepokari	ポテポカリ
neyu	ねゆ
yureru	揺れる
kageotoko	影男
ponyodora	ぽにょどら
minmin	みんみん
soato	そあと
kikka	橘花
wapa	わぱ
maikun	マイ君
kuranku	クランク
yuma	ゅま
rin	りん
arakidonsan	あらきどんさん
rui	るい
yugi	ゆぎ
nuuchi	ぬぅち
toki	とき
manpuku	まんぷく
yuramin	ゆらみん
inemurimajin	居眠り魔神
annu	あんぬ
ruino	るいの
sakuramochi	桜餅
kanami	かなみ
kiichi	きいち
ikachan	いかちゃん
taro	たろ
shizu	しず
koranda	コランダ
takuto	タクト
niente	にえんて
nozue	ノズエ
nanaonao	ななおなお
kurou	クロウ
sunapua	すなぷあ
tomonori	トモノリ
emu	えむ
dakumuu	だくむう
sasuke	さすけ
mekkyoso	めっきょそ
merumo	めるも
mono	もの
roteri	ろてり
nagaimaru	ながいまる
nomopi	のもぴ
hari	針
sasami	ささみ
fujisan	藤さん
haru	ハル
kyaruko	きゃる子
imo	芋
yumemakura	夢まくら
shitori	シトリ
nomeji	のめじ
usanoha	うさのは
kuromana	くろまな
keke	ケケ
penko	ペン子
matsuri	祭
jaruo	ジャルオ
hiratai	ひらたい
shirura	しるら
moai	モアイ
yoshiko	淑子
suzuto	鈴斗
sashimi	さしみ
mari	まり
kasumin	かすみん
amagumohebi	雨雲蛇
okita	おきた
guya	ぐや
toriinu	とりいぬ
reinadon	れいなどん
inaho	いなほ
matsunoha	まつのは
asari	あさり
yuyumeme	ゆゆめめ
hana	はな
oimochan	おいもちゃん
chinsan	ちんさん
ushimaru	うし丸
uyuchanhonpo	ぅゅちゃんほんぽ
kahorin	かほりん
denden	でんでん
hisui	ヒスイ
kisomitake	きそみたけ
vaara	ヴァーラ
kuma	くま
ron	ろん
masaki	まさき
nekokane	ねこかね
shioshio	シオシオ
hatsukona	はつこな
matsu	まつ
nao	なお
ukokkei	うこっけい
koha	こは
uta	ウタ
shokora	ショコラ
maria	マリア
matsuyoshi	まつよし
suruga	するが
sansotento	酸素テント
maron	まろん
sagaruya	さがるや
norina	のりな
joe	じょえ
remu	れむ
yue	ゆえ
sakako	サカコ
rura	ルラ
unoko	うのこ
hiko	ひこ
nakaba	なかば
tarou	たろう
chisa	ちさ
yuki	ユキ
inupanchi	イヌパンチ
ginko	銀子
kotono	琴乃
rura	ルラ
takana	たかな
kururu	くるる
yun	ゆん
fujino	藤乃
aramata	あらまた
kinose	木ノ瀬
yomogi	よもぎ
raito	らいと
yagi	やぎ
fujiemon	藤衛門
yuukarin	ゆうかりん
rani	ラニ
rakutoku	楽とく
meruviru	メルヴィル
futori	ふとり
mogaru	もがる
fu	芙
yosuga	よすが
botamochi	ボタモチ
pino	ぴの
hoshi	星
dedededede	ででででで
momoiro	モモいろ
konohairoha	このはいろは
yoshijirou	よしじろう
kirishima	キリシマ
nanase	ななせ
aruto	アルト
yukinko	ゆきんこ
niente	にえんて
fajiarunyu	ふぁじあるにゅ
ruriha	ﾙﾘﾊ
koruku	こるく
ikuyumu	いくゆむ
mana	まな
gomaruna	ごまるな
minirei	みにれい
nekotoawadama	ねことあわだま
naruki	なるき
ugorin	うご凛
oryou	おりょう
ungen	うんげん
imami	いまみ
mei	メイ
kahara	かはら
yumiso	ゆみそ
maaobasan	マーおばさん
nefue	寝笛
yuchamaru	ゆちゃまる
daibou	大坊
maria	まりあ
bokeboke	ボケボケ
raura	ラウラ
kanta	かんた
bashi	バシ
matatabi	またたび
mujirushi	無印
muku	ムク
shiki	シキ
kazutaka	かずたか
yasuto	やすと
koppyan	こっぴゃん
tamakon	たまこん
nanami	ななみ
umauma	うまうま
kuma	くま
nagisa	なぎさ
heitaku	へいたく
keita	ケイタ
mikageaki	御影アキ
shirosuzu	しろすず
asua	あすあ
motchi	もっち
ikkun	いっくん
tanso	炭素
koromo	ころも
yamamoto	やまもと
nukesaku	ぬけさく
hamachan	ハマちゃん
ajarimonta	あじゃりもんた
takanami	たかなみ
fate	ふぁて
suzune	すずね
nemusuke	ねむすけ
rakkyoumiso	らっきょう味噌
kinakomochi	きなこ餅
azu	アズ
sabanomisoni	サバの味噌煮
kiria	きりあ
resson	レッソン
nekomaruchan	ねこまるちゃん
ruripon	るりぽん
yasukichi	やす吉
suginoran	スギのラン
keema	けーま
mukkoro	むっころ
maho	まほ
kuro	くろ
pochi	ぽち
inpara	インパラ
yuno	ゆの
bayashi	バヤシ
agepanda	あげぱんだ
konamon	こなもん
riri	リ利
ararin	あらりん
okitarou	おきたろう
aomorinotanuki	青森の狸
utamaru	うたまる
suiminnokagaku	睡眠の科学
rumine	ルミネ
daifuku	だいふく
jinon	ジノン
niwatoru	にわとる
boipa	ぼいぱ
kino	きの
ewoi	ゑをゐ
konsuke	こんすけ
sakimori	さきもり
ruripon	るりぽん
sananan	さななん
sakamoto	サカモト
kyorochan	キョロちゃん
nakayama	中山
yasukichi	やす吉
gahito	ガヒト
wanko	わんこ
gonnooyaji	ゴンのおやじ
harojiro	はろじろ
nakayama	中山
takana	たかな
rasutan	ラスたん
zerunika	ゼルニカ
enomoto	榎本
iitenkisan	いいてんきさん
kaerun	かえるん
yuu	ゆう
usami	うさみ
aizawayasumi	相沢保美
raiha	ライハ
tsubasa	つばさ
maruyadanchi	丸屋団地
komadahachi	駒田ハチ
zenzai	ぜんざい
mikoto	みこと
sawa	さわ
uyu	うゆ
nekubi	寝首
hano	葉野
nekomon	ねこモン
riemama	りえまま
ryuuzen	りゅうぜん
mochi	もち
mochi	もち
yagamimisaki	八神みさき
aria	ありあ
mitsuru	みつる
sukotei	すこてい
romitanman	ろみたんまん
yumehana	ユメハナ
okatsu	おかつ
shinosaki	紫乃咲
yui	ゆい
suzutsuki	すずつき
mizo	みぞ
pikoharu	ぴこはる
aiko	あいこ
aoi	葵
nanji	汝
shiomasa	しおまさ
pentagon	ペンタゴン
aikatsukotowaza	アイカツことわざ
rururin	るるりん
kuribouzu	くりぼうず
tokio	時尾
yume	ゆめ
unizanmai	うにざんまい
satou	砂糖
satou	砂糖
maachan	まあちゃん
taisachamu	たいさちゃむ
nerine	ねりね
arata	あらた
potapota	ぽたぽた
yuni	ゆに
erika	えりか
iruma	いるま
ruamaru	ルアマル
miko	みこ
shousoro	しょうそろ
chama	ちゃま
konoha	木の葉
aochin	あおちん
minaho	ミナホ
howaito	ホワイト
waseimaru	わせい丸
ierahoki	いえらほき
mizu	ミズ
surun	するん
muku	ムク
purokon	プロコン
yuria	ユリア
marokoha	まろこは
bon	ぼん
buren	ぶれん
nerimayo	ねりまよ
arisa	ありさ
umu	うむ
risa	りさ
saonya	さぉにゃ
kikumaru	きくまる
yuuna	優菜
akinosora	秋野ソラ
ribeo	リベオ
miyaharu	みやはる
henarin	へなりん
mashiro	ましろ
usagineko	うさぎねこ
naori	ナオリ
yakionigiri	やきおにぎり
shirikon	しりこん
hokage	ほかげ
taisuke	たいすけ
kumano	熊野
murakamiamei	村神亜鳴
romutaisa	ロム大佐
kuroru	くろる
kumana	くまな
yoasobi	夜遊び
raisen	ライセン
akabane	アカバネ
urara	うらら
doromizususuru	泥水ススル
ika	いか
kanba	かんば
hasegawakazuo	長谷川一夫
ippaiattesa	イッパイアッテサ
tanishi	たにし
hiro	ひろ
aose	蒼瀬
yuna	ゆな
maruro	マルロ
kunasun	くなすん
katouiena	下等いえな
abi	あび
fukufuku	ふくふく
toha	とは
tento	てんと
shirosaba	しろさば
kamone	かもね
chichimotsu	ちちもつ
taisuke	たいすけ
mizuironowani	水色のワニ
yunoko	ゆのこ
honoka	ほのか
komeko	こめこ
toratoratora	とらとらとら
minmii	みんみー
sakupan	さくぱん
chibamakoto	チバマコト
kanninbukuro	堪忍袋
souichi	宗一
umetama	うめたま
fukuden	ふくでん
minatsu	ミナツ
takashi	タカシ
sazane	さざね
takamaru	たかまる
kuntama	くんたま
matamatasaburou	又々三郎
pekeponia	ぺけぽにあ
shoru	しょる
sakuratouri	桜とうり
okazu	おかず
gyabuneko	ぎゃぶねこ
rairamu	らいらむ
kuzupyon	くずぴょん
riri	りり
kumakumasan	くまくまさん
taisa	たいさ
sawarabi	さわらび
nunununonussan	ぬぬぬのぬっさん
hirakihokke	開きほっけ
samaki	さまき
nayumiya	なゆみや
kazurin	かずりん
wowan	ヲワン
gyouza	餃子
sushizanmai	すしざんまい
rana	らな
tora	とら
yuuki	優希
minami	みなみ
kamina	ｶﾐﾅ
agomogura	あごもぐら
mokomaru	もこ丸
makiron	マキロン
suigiso	すいぎそ
hisasu	ひさす
uchikubi	打ち首
hayoojisan	はよおじさん
happa	はっぱ
sunekosuri	すねこすり
suzuri	硯
ninnikuchuudoku	にんにくちゅーどく
kikura	きくら
sakurasora	桜空
nyami	にゃみ
haruto	はると
konbu	こんぶ
sukekiyo	スケキヨ
akaneko	赤猫
yuru	ユル
toppo	トッポ
kiruto	きると
matsunoumi	まつのうみ
imiju	いみじゅ
nemuchama	ねむちゃま
namururu	なむるる
sabo	さぼ
kohaku	琥珀
shui	しゅい
saon	サオン
yuzuringo	ゆずりんご
kaname	かなめ
haruka	はるか
kaname	かなめ
hinomaru	ひのまる
haruka	はるか
namakemono	なまけもの
shanazaki	しゃなざき
mentawa	めんたわ
sabo	さぼ
tsushi	ツシ
oga	おが
hinshibunkai	品詞分解
nazu	なづ
nontan	のんたん
nontan	のんたん
kohamu	こはむ
kohamu	こはむ
nontan	のんたん
nontan	のんたん
kohamu	こはむ
kohamu	こはむ
ferosan	ふぇろさん
kohamu	こはむ
imiju	いみじゅ
imiju	いみじゅ
momoko	ももこ
moshimofukiwo	モシモフキヲ
atonosu	アトノス
atonosu	アトノス
aki	あき
kameji	かめじ
sabo	さぼ
sabo	さぼ
guriko	グリコ
arinko	ありんこ
guriko	グリコ
sayakancho	さやかんちょ
arinko	ありんこ
rakuro	らくろ
negima	ねぎま
suzuki	すずき
saitamanekotou	埼玉猫党
shiroino	しろいの
nyai	にゃい
kotono	ことの
hina	ひな
itoinu	いと犬
funanko	ふなんこ
paisen	ぱいせん
asutoro	アストロ
fara	ファラ
hikina	ひきな
karuta	カルタ
aoiumikaze	葵うみ風
tankoro	タンコロ
kagura	神楽
aomofu	青もふ
konoyu	このゆ
hoshi	星
karasawa	唐沢
bogyan	ぼぎゃん
mikuto	みくと
berukiman	ベルキマン
junji	ジュンジ
gyouza	餃子
hinokano	ヒノカノ
fukuokabudou	福岡ぶどう
hanamaru	はなまる
sena	せな
morino	森乃
wataame	わたあめ
yamano	やまの
katoru	カトル
nanaka	ななか
hamayuu	はまゆう
takana	高菜
hinako	ひなこ
ringo	りんご
kadaya	カダヤ
kumada	くまだ
azuko	あずこ
shiranui	不知火
masakimaru	まさきまる
mori	森
saenaisuugakuto	冴えない数学徒
kuroda	黒田
bebisura	ベビスラ
rirutaru	りるたる
sakananorakuen	さかなの楽園
ayaki	あやき
seriri	せりり
mankumo	まんくも
kiyomaru	きよまる
megitarou	めぎ太郎
kakuni	角煮
aoitori	あおいとり
kirarinsakana	きらりんさかな
kirisame	霧雨
niserabi	にせらび
mika	ミカ
babachan	ばばちゃん
yuusuke	ゆうすけ
nishingyo	にしんぎょ
aochin	あおちん
yayoimochi	弥生餅
mochi	もち
anesama	あねさま
haikyo	廃墟
akipo	あきぽ
oshiemon	おしえもん
ari	あり
hanyou	はんよう
kirisame	霧雨
yagi	やぎ
kinoe	きのえ
yamamin	やまみん
enu	エヌ
kagura	神楽
shunpi	シュンぴ
mukada	むかだ
kawashima	川島
hono	ほの
manabo	まなぼ
hiro	ヒロ
tetsuyan	てつやん
sen	せん
ninomae	ニノマエ
anko	あんこ
minori	みのり
kohamu	こはむ
kakera	かけら
jii	じー
masaya	まさや
ryo	りょ
torihiki	取引
aru	アル
roku	六
roro	ろろ
unineko	うにねこ
aoitori	青い鳥
hana	華
ferosan	ふぇろさん
gaku	がく
mumumu	むむむ
hapya	ハピャ
kurome	くろめ
tobari	とばり
tokiko	ときこ
sake	さけ
choromaru	チョロ丸
hazuki	はづき
panya	パン屋
mugi	むぎ
noyu	のゆ
iwatobichan	いわとびちゃん
fujino	藤乃
rerameido	レラメイド
towamin	とわみん
mariko	真理子
sanroku	さんろく
anpan	あんぱん
tokine	ときね
ina	イナ
ken	けん
karasawa	唐沢
uni	うに
koori	こおり
joutochi	ジョウトチ
tantan	たんたん
nagamon	ながもん
yoshimi	よしみ
teruhime	輝姫
marushi	マルシ
naoyuki	なおゆき
kohaku	こはく
najun	なじゅん
sanyosefu	サンヨセフ
jojomeigen	ジョジョ名言
koume	小梅
tonnura	トンヌラ
pon	ポン
yumiso	ゆみそ
yakumo	八雲
burakken	ブラッケン
shii	しい
takehide	たけひで
ai	あい
chikanin	ちかにん
tonarinoshikibu	となりの式部
chisato	チサト
nanaya	ななや
mofuru	もふる
aoharu	アオハル
mofu	もふ
takehide	たけひで
yametekudasai	やめてください
saitoumiko	斉藤みこ
minito	ミニト
wakuwaku	ワクワク
yosshi	よっし
nakaihan	中居班
hatsuseshiwasu	初瀬師走
kansan	かんさん
naga	なが
ikutayoshikatsu	生田よしかつ
hamachi	ハマチ
chippii	ちっぴー
kurosu	クロス
rejimi	れじみ
poyo	ぽよ
azumi	あずみ
nekonyansuke	ねこにゃんすけ
yukihiko	ゆきひこ
yamapi	やまぴ
aoharu	アオハル
sora	そら
nagagutsupanda	ながぐつぱんだ
terutan	てるたん
chikara	ちから
ichikarin	いちか凛
onigiri	おにぎり
naritan	なりたん
honopiyo	ほのぴよ
yukihiko	ゆきひこ
nontan	ノンタン
hiboutaisaku	誹謗対策
homoaruaru	ホモあるある
risa	リサ
raayu	らーゆ
danmitsu	壇蜜
kohaku	こはく
asachan	あさちゃん
arare	あられ
tomunekotei	とむねこ亭
merieru	めりえる
rinna	りんな
mii	みい
hiichan	ひーちゃん
mineraruorenji	みねらるおれんじ
rito	りと
ruripon	るりぽん
yukihiko	ゆきひこ
akahiko	あかひこ
ramu	ラム
haru	はる
kazuchan	かずちゃん
awauo	あわうお
mayuge	まゆげ
yokubarimaman	欲張ママン
ushiushi	うしうし
ochamo	おちゃも
sayaka	さやか
shishichan	死死ちゃん
tomozou	ともぞう
kagurakurochan	神楽クロちゃん
kumano	くまの
mopio	もぴお
mana	ﾏﾅ
kuro	クロ
motona	モトナ
mofumofu	もふもふ
kandoranomaru	韓ドラのまる
runa	ルナ
tsukasa	つかさ
kiyomi	きよみ
yukiho	ゆきほ
chiyuki	チユキ
kaigunsan	海軍さん
achan	あちゃん
mofumofu	もふもふ
mayama	まやま
jupi	ジュピ
muuto	むうと
kumami	くまみ
nakatomiasuka	中富あすか
seichan	せいちゃん
inohige	イノヒゲ
kamiken	カミケン
yuukina	ゆうきな
naoya	ナオヤ
pirohiko	ピロ彦
rafutakaraka	らふたからか
ronto	ロント
kou	コウ
tae	たえ
akisuzu	あきすず
nose	のせ
hiro	ヒロ
uchako	うちゃこ
garukia	ガルキア
mi	み
shizuku	雫
mittopapa	みっとパパ
popomaru	ぽぽまる
suigorou	酔誤郎
aosan	あおさん
yone	よね
deden	ででん
yakiniku	焼肉
sumaki	すまき
chan	ちゃん
shinden	しんでん
nemunemunemuko	ねむねむねむこ
shinomori	しのもり
aritan	ありたん
mano	マノ
yoika	よいか
mikage	御影
kyoutatsu	響辰
shizuku	雫
horitamaru	ほりたまる
furanyan	ふらにゃん
bunbougusan	ぶんぼうぐさん
himihimi	ヒミヒミ
pandorayukkuri	ぱんドラゆっくり
sudaashiya	須田葦也
akibachiyo	秋葉ちよ
akua	アクア
ruripon	るりぽん
tsukimurakoushi	ツキムラコウ詩
yana	やな
fukaeri	ふかえり
mametanku	まめたんく
kokko	コッコ
yukinarineko	ゆきなりねこ
ruria	ルリア
hiyorin	ひよりん
anka	あんか
gomachie	ごまちえ
sagutsu	さぐつ
mimato	みまと
mirara	みらら
nyata	ニャタ
kei	ケイ
sakanaao	魚青
toropen	とろぺん
etsuo	えつお
naoko	ナオコ
shuri	珠莉
takahata	高幡
hirorin	ひろりん
honopiyo	ほのぴよ
unizanmai	うにざんまい
kingyo	きんぎょ
reito	れいと
ringo	りんご
mikan	みかん
yukari	ゆかり
teki	てき
mana	まな
momo	もも
ameshi	あめし
yutori	ゆとり
ichigochoko	いちごちょこ
uruhachan	うるはちゃん
kotamaru	コタ丸
yuse	ゆせ
kantakko	かんたっこ
aika	あいか
aya	あや
surume	するめ
macha	まちゃ
nosuriko	のすりこ
suiren	すいれん
nya	にゃ
sekina	せきな
karitachi	カリ太刀
kirinremonkun	キリンレモンくん
harusame	春雨
nemoko	ねもこ
kazurin	かずりん
kosauchi	コサウチ
kura	くら
kotoha	ことは
shauetsu	しゃうえつ
koroiya	ころいや
tsumeko	爪子
kiyoya	キヨヤ
yuzu	柚子
sunagami	すながみ
kashiwa	カシワ
tenrai	天籟
soumyon	そうみょん
harachan	はらちゃん
shiranamichan	しらなみちゃん
sagato	さがと
pikko	ぴっこ
haruhisa	はるひさ
bibiriaruaru	ビビりあるある
yaabon	やぁぼん
aya	綾
tapasan	たぱさん
okura	おくら
nopufi	ノプふぃ
nabe	なべ
narupajin	ナルパジン
nao	なお
sebachan	せばちゃん
takapon	タカポン
aika	あいか
oro	おろ
oukatei	桜花亭
zayakuchan	座薬ちゃん
kurumi	くるみ
usagiotoko	うさぎおとこ
aichan	あいちゃん
mion	みおん
rikutaro	りくたろ
mun	むん
fuuna	ふーな
ren	れん
ayuka	あゆか
aoi	アオイ
mesoko	めそこ
arumi	あるみ
denguma	でんぐま
otohasaki	音葉咲
susaria	スサリア
nurumeko	ぬるめこ
murako	むらこ
maru	まる
tsukamura	ツカムラ
miyasumi	みやすみ
shieri	シエリ
setsunyan	せつにゃん
mikan	みかん
suzu	すず
roto	ろと
chomo	ちょも
jin	じん
namaharumaki	なまはるまき
nana	なな
niko	にこ
hakota	箱田
azu	あず
kurenoomoide	呉の思い出
ruka	るか
arino	有野
izuya	いずや
yukisora	雪空
hayashi	はやし
choko	チョコ
rita	リタ
sekken	せっけん
poyo	ぽよ
erumisu	エルミス
youzen	陽全
shiyou	しよう
miwato	みわと
teitoku	ていとく
demae	でまえ
arisa	ありさ
menma	めんま
chitose	千歳
esse	エッセ
takumi	匠
hayonero	はよねろ
nehitama	ねひたま
mizuna	ミズナ
byonbyon	びょんびょん
haru	はる
umi	うみ
yukino	ユキノ
rio	りお
hakumai	はくまい
sui	スイ
fukami	フカミ
sassa	さっさ
yamo	やも
atsuki	あつき
nuuboo	ぬーぼー
sonoka	そのか
kurage	くらげ
rapiko	らぴ子
tasuku	タスク
kengo	けんご
ayakage	綾影
chibamari	ちばまり
korinsaya	こりんさや
chachako	茶茶子
toko	とこ
sui	スイ
koideyasuhiro	小出康弘
raito	らいと
oohirume	おおひるめ
wakonosuke	わこのすけ
keina	けいな
eriasu	エリアス
toko	とこ
morinohiro	森野ヒロ
piriodo	ピリオド
hitode	ひとで
towabayashi	トワバヤシ
taa	たあ
masumihikidashi	真澄ひきだし
buntaka	ブンタカ
kunopero	くのペロ
nasubi	なすび
abunishu	アブニシュ
yuyuchiku	ゆゆちく
saya	さや
kotodama	コトダマ
seyanen	せやネン
fukushia	ふくしあ
seteko	せてこ
aobara	青薔薇
tsumuse	つむせ
tokoton	トコトン
utsuminamiko	内海奈美子
oro	おろ
shiori	栞
shion	紫苑
minato	みなと
amiri	あみり
akarin	あかりん
soa	そあ
amagi	天城
sodekiri	そできり
aniyan	あにやん
haniwappo	ハニワッポ
raiba	らいば
giyuichi	ぎゆ壱
kahanshin	かはんしん
takamo	たかも
hidakashinji	日高慎二
ayuna	あゆ菜
kaga	加賀
takkun	たっくん
hika	緋架
yamapiro	やまぴろ
tanaka	田中
tomea	とめあ
rara	らら
shiratama	しらたま
yamakashi	ヤマカシ
shimaken	しまけん
ibikineko	鼾猫
taka	たか
soroisoroi	ソロイソロイ
amei	阿明
kenchan	ケンちゃん
burian	ブリアン
samidare	五月雨
sanakichi	さなきち
icha	イチャ
chukamama	ちゅかママ
noumisazamichi	能見さざみち
yua	ゆあ
riruto	りると
harupaa	はるぱぁ
monte	モンテ
yamafuso	やまふそ
sea	セア
shiruko	しるこ
nimo	にも
mumu	むむ
noi	のい
tamaguchi	たまぐち
akarin	あかりん
takuan	たくあん
keroama	けろあま
main	マイン
mimiruku	みみるく
amagasa	雨傘
yukimi	雪見
tomatozerii	トマトゼリー
kitone	キトネ
tsubasa	翼
soneri	そねり
saegusa	さえぐさ
reru	れる
reruri	れるり
hiroara	ひろあら
fuchizaki	フチザキ
ginsuke	ぎんすけ
mizuho	みずほ
karin	カリン
torinosasami	とりのささみ
nekodaisuki	猫大好き
yoshidababu	吉田バブ
suzu	すず
mayu	まゆ
nichimaru	にちまる
ichitarou	いち太郎
hanananana	はなななな
nekomenkaja	猫面冠者
sagaruya	さがるや
anyaru	あにゃる
rakka	ラッカ
shibamike	シバミケ
hayataka	はやたか
dande	ダンデ
uepon	うえぽん
yukihira	ゆきひら
maronpapa	マロンパパ
ken	謙
somekobarin	染古場凛
totsuzen	突然
nyun	にゅん
daifuku	だいふく
menmen	めんめん
shiroitao	シロいたお
yuka	ゆか
hane	羽
honchu	ほんちゅ
koharuko	こはる子
yutaka	ゆたか
kashi	樫
seikaitan	政界たん
maron	まろん
meron	メロん
nemu	ねむ
shiro	シロ
ukapichan	うかぴちゃん
sagutsu	さぐつ
nemunemunemuko	ねむねむねむこ
chamina	ちゃみな
makonyan	まこﾆｬﾝ
pochi	ポチ
edoirai	江戸いらい
shinon	シノン
tarukon	タルコン
sakemasu	鮭鱒
hika	緋架
mataron	またろん
nosuke	のすけ
nayuta	なゆた
kariya	かり屋
nonko	のんこ
nozomi	のぞみ
mosa	もさ
tsuchinoko	ツチノコ
sorato	空斗
nayuki	菜雪
saegusa	さえぐさ
nasumoku	なすもく
haru	ハル
sunaisaki	すないさき
tokio	時尾
uzuki	卯月
ponzu	ぽんず
donya	どんや
sena	せな
tomatoyasan	トマトやさん
sanokirichosu	佐野きりちょす
shigesan	しげさん
suzukireru	鈴木れる
chon	ちょん
ruza	るざ
chidori	ちどり
gon	ごん
suzuna	すずな
megumi	メグミ
unitan	うにたん
haru	ハル
taroimo	タロイモ
yoshi	よし
nonko	のんこ
aumi	あうみ
a	ｱ
non	ノン
napisu	なぴす
ageninniku	あげにんにく
uzuki	卯月
nagito	ナギト
suigin	水銀
kogepanda	こげぱんだ
gon	ごん
tankeshi	たんけし
rei	玲
uyuyu	うゆゆ
roritan	ろりたん
yuka	ゆか
enadori	エナドリ
sakanauma	さかなうま
kanapyon	かなぴょん
yuu	ゆう
manekichi	マネキチ
raame	らーめ
kamitaku	かみたく
yuzuneko	柚子猫
yae	ヤエ
miyuna	みゆな
toyo	トヨ
nakasan	中さん
sun	すん
satomin	さとみん
ponta	ぽんた
haru	ハル
yunoemon	ゆのえもん
yuzuki	ゆずき
yukiwo	ゆきを
akametakuya	アカメタクヤ
mossama	もっさま
konoha	このは
ruisabu	ルイサブ
shironeko	白猫
shiki	シキ
ariaberu	アリアベル
minto	ミント
ierisousaku	イエリ創作
nekonabe	猫鍋
rio	りお
kaeru	蛙
yurin	ゆりん
ai	あい
aroppo	あろっぽ
sumyon	すみょん
nigiyaka	にぎやか
hinoen	日野苑
sana	紗奈
shouwanokaseki	昭和の化石
mataron	またろん
mizuna	みずな
nomani	のまに
torinosasami	とりのささみ
yuutomo	ゆーとも
nanahoshi	ななほし
naosan	なおさん
maha	マハ
naochan	なおちゃん
kasumin	かすみん
rutsuri	るつり
marokun	まろ君
sasanishiki	ささにしき
kairingo	かい林檎
kohaku	こはく
rimuru	りむる
poou	ぽーう
tanyaka	たにゃか
roki	ロキ
hiromi	ひろみ
darudaru	だるダル
hiromaru	ひろまる
tori	とり
niseojiro	ニセオジロ
ringo	りんご
satousu	さとうす
engawa	えんがわ
yumetama	夢玉
kekeponpon	けけぽんぽん
shouko	しょうこ
kanobuta	かのぶた
saisoku	さいそく
gorira	ごりら
kitadamasaya	北田雅也
aoringo	あおりんご
tsubakichi	つば吉
fugashina	ふがしな
sorao	そらお
ei	エイ
tenikuni	ﾃﾆｸﾆ
kotoneon	ことねおん
yukihira	ゆきひら
taa	たあ
rio	リオ
yukinyo	ユキニョ
rama	らま
sukai	スカイ
keron	けろん
hibiki	ヒビキ
hiwa	鶸
tai	たい
kumaei	くまえい
sayo	さよ
tamo	たも
nagi	ナギ
keeruretasu	けーるれたす
kumachan	くまちゃん
koguma	子ぐま
kunta	クンタ
nakashi	ナカシ
ruza	るざ
rira	リラ
kaeru	蛙
zokusei	属性
taruto	タルト
suwa	すわ
aaaa	ああああ
zenpikasensei	全ピカ先生
saanoya	さあのや
yukimaru	ゆきまる
urara	ウララ
hikage	ヒカゲ
kiona	キオナ
haraodori	はらおどり
mariko	鞠子
tominomito	富乃みと
nishizawa	西澤
momoka	ももか
makoto	真琴
moruniyaken	もるにやけん
machidamegane	町田メガネ
roka	ろか
meru	める
masa	まさ
nayu	菜湯
kirerun	キレルン
fuwafuwanoinu	ふわふわのいぬ
yaku	やく
houkifuji	伯耆富士
maro	まろ
zudon	ずどん
maonasu	まおなす
pupu	ぷぷ
hiwatari	ひわたり
uruchi	うるち
nitarazuyutonko	にたらずゆとんこ
danu	だぬ
ayumi	あゆみ
eruu	えるぅ
sengoku	せんごく
orufisu	おるふぃす
mizuto	水ト
anko	あんこ
ryuuto	リュート
takashi	たかし
yama	やま
rakusu	らくす
yumesaki	ゆめさき
anko	あんこ
aurora	あうろら
emizebu	えみぜぶ
yuu	ゆう
morito	モリト
maria	まりあ
asuma	あすま
cheke	ちぇけ
ajitama	あじたま
kairingopero	かいりんごぺろ
amechika	あめちか
yadakusuri	矢田くすり
yato	やと
gurausu	グラウス
arakane	アラカネ
makipon	まきぽん
dai	だい
sasaki	佐々木
dozaimonta	どざいもんた
panda	ぱんだ
moguzou	もぐぞう
samekichi	さめきち
paichi	ぱいち
unyoki	うにょき
tae	たえ
pochishiba	ポチシバ
shutto	しゅっと
gonbe	ゴンベ
kira	キラ
kandagawa	神田川
shutto	しゅっと
chino	ちの
ryu	りゅ
hanumaru	はぬまる
menou	めのう
kyon	キョン
yamadayoshikawa	ヤマダヨシカワ
kyou	きょう
anero	あねろ
miwato	みわと
sorarisu	ソラリス
umeko	梅子
rana	ﾗﾅ
raame	らーめ
pirorin	ぴろりん
kazumarosushi	かずまろ寿司
ohagi	おはぎ
okaratanto	オカラタント
koyori	こより
yuuki	ゆーき
chishami	ちしゃみ
minami	みなみ
nanataka	ななたか
sagato	さがと
nannan	なんなん
hesokusao	へそくさお
menkoi	面恋
chiro	ちろ
chokoneko	ちょこ猫
kaya	かや
wakayamahiroshi	若山寛
amahira	アマヒラ
konoha	木の葉
rion	りおん
nitarazuyutonko	にたらずゆとんこ
aousagi	アオうさぎ
tamani	たまに
shishirui	死屍累
kento	けんと
maki	槙
sakura	さくら
sakura	さくら
jun	ジュン
isuseizouki	椅子製造機
nurumayu	ぬるまゆ
pan	ぱん
aoimanabu	あおいまなぶ
meno	メノ
yukkyo	ゆっきょ
warewarenodouga	我々の動画
usagiotoko	うさぎおとこ
shimamaru	しままる
rira	利羅
sakurako	桜子
aoiumikaze	葵うみ風
tomason	トマソン
nanushi	名主
nerune	ネルネ
makipon	まきぽん
nekomaruta	ねこまるた
honryaku	本略
toraya	寅弥
isofura	いそふら
yottare	よったれ
yurine	ユリネ
nananashiko	なななし子
kazuya	かずや
kurokawa	黒川
ori	おり
aoi	あおい
aniki	あにき
ruina	るいな
nyanta	にゃんた
hinata	ひなた
keita	啓太
suetsugu	すえつぐ
yamanekoken	山猫軒
uzume	うずめ
kazumama	かずまま
toki	とき
riria	リリア
torihiko	鳥彦
hibiki	ヒビキ
miyukichacha	みゆきチャチャ
kuzukumasan	くずくまさん
shishamo	ししゃも
toropikaron	とろぴかろん
sumeshi	酢めし
umeshu	うめしゅ
rikako	りかこ
kamichan	神ちゃん
reoerana	レオエラナ
satoru	さとる
inaemi	いなえみ
asato	あさと
yumikko	ゆみっこ
nene	ねね
shiratama	しらたま
kanae	かなえ
kouchapurin	紅茶プリン
rumagiku	ルマギク
morige	もりげ
kenkichi	けん吉
hodaka	ほだか
kitsune	きつね
madao	マダオ
nekoze	猫背
mugichan	むぎちゃん
yumota	ゆもた
kasaiji	かさいじ
iiyo	ｲｲﾖ
yoshifumi	ヨシフミ
naokigenia	ナオキゲニア
sawara	さわら
dabochan	ダボちゃん
kiyui	きゆい
yuki	ユキ
akanko	あかんこ
chikotarou	ちこ太郎
youko	陽子
kuromame	くろまめ
rio	りお
akira	晃
shiho	シホ
yukina	雪那
inaniwayoukan	稲庭羊羹
aya	あや
tahhyo	たっひょ
sumineko	すみねこ
seina	せいな
sawahato	サワハト
sakanachan	さかなちゃん
nagasekun	ながせくん
tsuchio	ツチオ
tanu	たぬ
popo	ぽぽ
shiho	しほ
atsuki	あつき
mai	まい
renakka	れなっか
masaki	まさき
yoshikun	よしくん
shishimaru	獅子丸
yukinyanko	ゆきにゃんこ
metabonapapa	メタボなパパ
bonzo	ぼんぞ
marisuke	まりすけ
kinui	きぬい
puitsupo	ぷいつぽ
risao	りさお
uminekotatsu	うみねこたつ
perua	ぺるあ
fuwaru	ふわる
azarashi	あざらし
kuro	くろ
kirin	キリン
taiki	たいき
tanyao	たにゃお
mai	真衣
wakuwaku	わくわく
takigura	たきぐら
hetehete	へてへて
yamimika	やみみか
kamiya	神谷
yassan	やっさん
ruka	るか
potoraru	ぽﾄらる
ringo	りんご
naminamina	ナミナミナ
miyacha	みやちゃ
yukiusagi	ゆきうさぎ
otakaradouga	おたからどうが
takechiyo	たけちよ
satou	佐藤
yuuto	ゆうと
yametekudasai	やめてください
uribou	うり坊
oyasumishirasu	おやすみしらす
hirohige	ひろひげ
ai	あい
jiisangenki	爺さん元気
yukkya	ゆっきゃ
kumakuma	くまくま
itachi	イタチ
sotan	そたん
kopene	こぺね
tsumutsumu	つむつむ
hirohige	ひろひげ
ponuzo	ぽぬぞ
maimi	まいみ
tenkino	天キノ
yutanpopon	ゆたんぽぽん
deyuyama	でゆ山
takechiyo	たけちよ
yuratama	ゆらたま
yurinotomo	百合の友
kikirio	キキリオ
moai	もあい
taketon	たけとん
asairimame	浅煎り豆
zanomono	ざの者
sasayan	ささやん
fuyu	冬
aizakiryou	あいざきりょう
ruumoche	るぅもちぇ
kaminari	カミナリ
chinopon	ちのぽん
shuu	しゅう
mikan	みかん
minito	ミニト
sunarion	スナリオン
hanappo	華っぽ
jupi	ジュピ
kamiyan	かみやん
nenemu	ねねむ
honeori	ホネオリ
yakiniku	焼肉
ruuki	ルウキ
ebishan	えびしゃん
ikageso	イカゲソ
seseragi	せせらぎ
takechin	たけちん
yurabikun	ゆらびくん
hisui	ひすい
yuria	ゆりあ
yuria	ゆりあ
eguzari	えぐざり
yurabikun	ゆらびくん
nizu	にず
randokunikki	濫読日記
hokorin	ほこりん
kuropochi	くろぽち
kabuchan	かぶちゃん
hiro	ヒロ
misakananoha	御坂なのは
yakan	やかん
takechin	たけちん
takechin	たけちん
kazuchan	カズちゃん
doraran	ドララン
shimauma	しまうま
kikumaru	菊丸
nezumiseijin	ねずみ星人
pechikun	ぺちくん
nikkun	にっくん
kamisan	かみさん
yuzukorone	ユズコロネ
oresabosan	俺サボさん
karuchienau	カルチエなう
hadoirun	はどいるん
kishio	き塩
season	せあそん
mire	みれ
mire	みれ
kooki	コーキ
miyako	都
hiria	ヒリア
konan	コナン
ayasaki	綾崎
nekura	ねくら
onigiri	おにぎり
yutori	ゆとり
kaedemaru	かえでまる
tomoko	ともこ
yuuri	ゆうり
ankosan	あんこさん
okitsune	おきつね
uho	うほ
minto	みんと
kyou	匡
rojiura	路地裏
kogetaosenbei	焦げたお煎餅
rikka	りっか
nakashi	なかし
tarumiwarabi	垂水わらび
tsunamayo	ツナマヨ
orichiya	おりち屋
ogakuzu	おがくず
shibugaki	渋がき
arakidonsan	あらきどんさん
namururu	なむるる
owanchan	おわんちゃん
togine	トギネ
aya	あや
shio	しお
karaage	からあげ
sakanabone	さかなぼね
amuro	あむろ
mino	みの
sugisugi	杉すぎ
gumi	ぐみ
shuka	シュカ
mimuni	みむに
zappen	ざっぺん
kouyanyanko	荒野にゃんこ
marumo	まるも
hitomisan	ヒトミサン
kaori	かおり
honryaku	本略
eon	エオン
hitomisan	ヒトミサン
nyari	にゃり
suppi	すっぴ
zappen	ざっぺん
yunen	ゆねん
negoto	ねごと
gomamiso	ごまみそ
haruchika	ハルチカ
umikirei	うみきれい
harupiyo	はるぴよ
yappo	やっぽ
futaba	双葉
okaka	おかか
amiyu	あみゆ
yuni	ゆに
zeddaru	ゼッダル
toneunga	利根運河
sousukedon	そうすけどん
noemo	ノエモ
munehiro	むねひろ
kuriuzu	くりうず
inarisan	いなりさん
bananasakana	バナナさかな
keipyon	けいぴょん
ekitai	えきたい
vakaunto	ヴァかうんと
faminofusan	ファミノフ産
tanaka	たなか
sassa	さっさ
runa	るな
chiko	ちこ
risachi	りさち
ayumukkun	あゆむっくん
shigure	シグレ
yama	やま
miyaneyafan	ミヤネ屋ファン
konatsupin	こなつぴん
rito	りと
kuroageha	クロアゲハ
nugu	ぬぐ
yonesuke	ヨネスケ
sa	さ
setsu	せつ
tomomi	ともみ
ibuki	伊吹
nene	ねね
sufuna	スフナ
senon	せのん
kazamatsu	かざまつ
hiramin	ひらみん
kyomatan	きょまたん
manoiroiro	まのいろいろ
rin	りん
erumisu	エルミス
koharu	こはる
guyun	ぐゆん
tsunamayo	ツナマヨ
garaemon	がらえもん
negimaru	ネギ丸
zauko	ザウコ
rimu	りむ
chitonyan	ちとにゃん
kawashima	かわしま
usagiriri	うさぎりり
kuroageha	クロアゲハ
daichan	だいちゃん
hangetsu	はんげつ
mogidori	もぎどり
yoru	よる
kohaku	こはく
kiyobei	きよべい
ayaneko	あやねこ
ritsu	りつ
santaka	さんたか
wataame	わたあめ
kishimen	きしめん
niwatori	ニワトリ
hikararu	ひからる
torikinoko	とりきのこ
sou	爽
yoru	よる
gomafu	ごまふ
asuto	アスト
yunko	ゆんこ
bantan	ばんたん
heki	ヘキ
naoemon	ナオエモン
suu	すぅ
oron	おろん
kodakawa	こだかわ
rioneko	りぉねこ
imokenpi	芋けんぴ
manasutechan	マナステちゃん
omugisama	おむぎ様
uruama	うるあま
azaran	アザラン
borochi	ぼろち
omiso	おみそ
usatan	うさたん
oitan	おいたん
kokounoneko	孤高の猫
usatan	うさたん
ayaka	あやか
yagamin	八神ん
ito	いと
oguri	オグリ
dai	だい
kirumi	きるみ
engi	エンギ
hanamaru	はな丸
hazuki	葉月
mika	みか
mochiko	もちこ
ichi	壱
ineuchi	いねうち
urugusu	ウルグス
roase	ろあせ
uni	うに
minonegi	みのねぎ
momo	もも
inunabe	犬鍋
sakuyan	さくやん
yaawa	やあわ
nanase	七瀬
hiyo	ひよ
robita	ロビタ
sayayan	さややん
kagerou	かげろう
marokun	まろ君
toro	とろ
ayaya	あやや
asagi	あさぎ
sanso	酸素
aki	あき
ichimura	壱村
makinko	まきんこ
ten	ﾃﾝ
manami	まなみ
pankona	パン粉
miyaji	ミヤジ
aka	ァヵ
atsumori	あつ森
mosuyan	もすやん
miku	みく
ishikawa	イシカワ
hanpepe	はんぺぺ
hikari	ひかり
kamushin	かむしん
tape	タペ
kanekane	かねかね
tadaaku	ただぁく
noramimi	のらみみ
ran	らん
yukiringo	雪りんご
momo	もも
ama	ぁま
akaka	アカカ
kaimun	かいむん
hibiware	ひびわれ
dai	だい
maya	まや
misumaru	みすまる
kiato	きあと
makaron	まかろん
yukiyanagi	雪柳
kache	カチェ
yozakurakanata	夜桜彼方
suntoraru	すんとらる
maru	まる
kujitaso	くじタソ
tomomin	ともみん
namuhokabu	なむほ株
hiiragishi	柊氏
fujisan	ふじさん
rikutaro	りくたろ
mu	む
hyon	ひょん
senchan	せんちゃん
mamecha	豆茶
sakinko	さきんこ
hokahokagohan	ほかほかごはん
borurin	ぼるりん
rui	るい
kaede	かえで
tobiuo	トビウオ
noichigo	のいちご
bikke	びっけ
sazanami	さざなみ
tsurumi	鶴見
komutomo	こむとも
jun	じゅん
shiroe	しろえ
tachibana	立花
kurage	くらげ
akuro	あくろ
kanamaru	佳奈丸
komachi	こまち
kaiki	かいき
omoiyari	重い槍
chami	ちゃみ
masaka	まさか
hanamame	はな豆
ponsupon	ポンスポン
torisakisan	鳥咲さん
nagata	ながた
miru	みる
nikopa	ニコぱ
misa	みさ
yurunatsu	ゆるなつ
akiakane	秋茜
kurasan	くらさん
takeshin	たけしん
kotori	コトリ
ryokuu	りょくう
kano	かの
tomorin	ともりん
keroppe	けろっぺ
tezu	てづ
rei	怜
subain	スバイン
ebiten	えびてん
shibatan	しばたん
byonbyon	びょんびょん
mimei	ミメイ
kokeshichan	こけしちゃん
rukkun	るっくん
popo	ぽぽ
mitarashi	みたらし
imoni	いもに
sakinko	さきんこ
toriudon	とりうどん
hone	ほね
oichi	おゐち
kamimama	かみまま
yukatama	ゆかたま
ayu	あゆ
tomokichi	ともきち
ringo	りんご
yuka	ゆか
nike	にけ
taidanamikasa	怠惰な三笠
koni	コニ
tsunenenene	つねねねね
yuusukepapa	ゆうすけパパ
hiro	ひろ
haruhi	はるひ
hirasawayuki	平沢ゆき
karuna	かるな
seiga	せいが
sakeshiki	酒式
aya	あや
zaburin	ざぶりん
nen	ねん
poporebuta	ポポれ豚
mami	まみ
ichumin	いちゅみん
yuki	ユキ
hisa	比佐
soraneko	空猫
mariotaku	まりおたく
imakami	いまかみ
daigorou	だいごろう
eko	えこ
mero	めろ
masshiroro	まっしろろ
miina	みぃな
shun	しゅん
marusan	まるさん
bea	べあ
wakka	わっか
rao	らお
kimukimu	キムキム
nosuke	のすけ
shaa	シャア
someishitsu	染井悉
shikon	紫紺
mizue	みずえ
rubetama	るべたま
remonneko	レモンネコ
yoko	よこ
ougimaneki	扇マネキ
tsunetan	ツネタン
botan	ぼたん
nagon	なごん
daichi	だいち
haru	ハル
mamarin	ままりん
onsoku	おんそく
tamahiyo	たまひよ
daidaishi	ダイダイ氏
pache	パチェ
aya	あや
yasu	やす
sasami	ササミ
tomohisa	ともひさ
riia	リイア
ranki	ランキ
kyutte	きゅって
penta	ぺん太
fujikkun	ふじっくん
mogami	モガミ
uhyou	うひょう
uhyou	うひょう
kurunsan	くるんさん
oisumiuki	おいすみうき
koyata	こやた
irutori	いるとり
mipoka	みぽか
aya	アヤ
marumaru	丸々
gussan	ぐっさん
koto	こと
aki	アキ
tomozu	ともず
uimamakawaii	ういままｶﾜｲｲ
reon	れおん
nana	なな
obabu	おばぶ
aki	アキ
nami	ナミ
mauta	まうた
fumiharu	フミハル
haruka	ハルカ
fuwari	ふわり
aomi	あおみ
hamamatsusayaka	浜松さやか
momiji	もみじ
miyanagaharu	宮永ハル
kanakawa	かなかわ
koitan	こいたん
munini	むにに
hajimekun	はじめくん
itsukichi	いつきち
edochin	エドちん
hinori	ひのり
toki	とき
nagito	なぎと
michihiro	みちひろ
oyatsuhime	おやつ姫
hyura	ひゅら
mukaikaze	むかいかぜ
hatsuka	はつか
odachamame	おだちゃ豆
haka	はか
aya	あや
yuki	ゆき
dekoboko	でこぼこ
riara	りあら
funo	ふの
harupirua	ハルぴるあ
kikaionchi	機械音痴
usagi	うさぎ
ayataka	あやたか
inpara	インパラ
nuefukurou	ぬえふくろう
shun	しゅん
hinowaku	ひのわく
hagakikatteren	ハガキ勝手連
shun	しゅん
shimarin	しまりん
shigure	時雨
shun	しゅん
raiteu	ライテウ
manaka	まなか
taka	たか
hikaru	ひかる
nakawa	なかわ
yuusaku	ゆうさく
uyuyu	うゆゆ
tsunetan	ツネタン
nagata	長田
koyorimaru	こよりまる
tententan	てんてんたん
echuneko	えちゅ猫
yuu	ゆう
minaruma	ミナルマ
naranoneko	奈良のねこ
miyuki	みゆき
nattaro	なったろ
koto	こと
hideaki	秀明
jun	じゅん
gaku	がく
iryorogi	いりょろぎ
meganemaru	めがねまる
utage	うたげ
naoto	ナオト
raichi	らぃち
ike	池
kuromame	くろまめ
oshamoji	おしゃもじ
omatsu	おまつ
soumyon	そうみょん
hanatemari	花てまり
heki	碧
bunashimeji	ぶなしめじ
chidorimanjuu	千鳥饅頭
karen	かれん
anton	あんとん
ponko	ぽんこ
rio	リオ
maki	まき
neon	ねおん
maaburu	まぁぶる
natsumi	なつみ
zakkamatome	雑貨まとめ
kurorera	クロレラ
sakumo	ｻｸﾓ
hiyoriyon	ひよりよん
kotaemi	ｺﾀｴﾐ
kaeru	カエル
junchan	じゅんちゃん
sharu	シャル
kei	けい
otako	おたこ
kino	木野
yoshino	ヨシノ
hokutaka	ほくたか
isaki	いさき
herubechika	へるべちか
socha	粗茶
suiren	睡蓮
pikarin	ぴかりん
kinmokusei	きんもくせい
sakanapan	さかなぱん
takechan	タケちゃん
meichan	めいちゃん
yozakura	夜桜
neramin	ねらみん
akihoshi	あきほし
yonesuke	よねすけ
tanupon	たぬぽん
hatena	ハテナ
yuuna	ゆうな
shun	しゅん
raiko	ライコ
akumya	あくみゃ
hoshikake	ほしかけ
aun	阿吽
nikujaga	にくじゃが
papabusa	パパブサ
masayuki	マサユキ
kayajin	かやじん
toto	トト
kawauso	かわうそ
dentanchan	電探ちゃん
kasouro	火葬炉
shizuku	雫
takaka	たかか
nekokan	猫缶
matcha	まっちゃ
shige	しげ
yuki	ゆき
ponsui	ぽんすい
yanagi	柳
suteusa	すてうさ
ririan	ﾘﾘｱﾝ
momo	もも
aira	アイラ
shiropanda	白ぱんだ
ayapani	あやぱに
ibuki	いぶき
emyuu	えみゅー
gintoki	ぎんとき
tomi	トミ
mami	まみ
misumaru	みすまる
makoyan	まこやん
natsuki	なつき
chimu	ちむ
takara	宝
tette	てって
taroinu	たろいぬ
rimano	りまの
rihana	りはな
yanderekaga	ヤンデレ加賀
amefurinojiji	雨降りのジジ
shimeji	しめじ
naru	なる
himekurichan	ひめくりちゃん
mizuharamutsumi	みずはらむつみ
nonomun	ののむん
koto	コト
torao	とらお
mamepan	まめぱん
daiki	だいき
kurowo	クロを
kajirimaru	かじりまる
sasaki	佐々木
mochidori	もちどり
sakupon	さくぽん
konose	ｺﾉｾ
hirase	ひらせ
kurousagi	黒ウサギ
yamurokasei	やむろかせい
hemu	ヘム
natsume	なつめ
mashira	ましら
nana	なな
daicho	ダイチョ
rinokun	りのくん
pukichi	ぷきち
inako	いなこ
gamanjirukata	がまんじるかた
usagiotoko	うさぎおとこ
nijibiyo	にじびよ
negita	祢宜田
kohapapa	こはパパ
komesawa	こめさわ
manyuaruchan	まにゅあるちゃん
touya	とうや
hirokun	ひろくん
ookami	おお紙
natadekoko	なたでここ
niwayama	にわやま
manatan	まなたん
tadanomichi	ただの道
nao	なお
gai	ガイ
sakaki	さかき
kareha	枯葉
hagatan	ハガたん
saeyuka	さえゆか
menchan	めんちゃん
yuyumaru	ゆゆ丸
aten	あてん
suke	すけ
geboku	下僕
jumitaka	じゅみたか
takuten	たくてん
hoshi	ホシ
miso	みそ
ushiro	ウシロ
matsumotomorio	松本森男
nukopoppo	ぬこぽっぽ
uni	うに
omatsu	おまつ
mii	みい
miyochi	みよち
osushidesukedo	おすしですけど
chatanabe	ちゃたなべ
yokonaka	横中
madoinu	まどいぬ
tomunya	とむにゃ
ohanaya	お鼻屋
maru	まる
heiwadai	平和台
mikoto	みこと
seoha	せおは
nattsu	なっつ
itomachi	糸街
oukasaki	桜花咲
koha	こは
nainai	ないない
poriko	ぽりこ
dangushi	だんぐし
sasorizanoonna	さそり座の女
makoto	真琴
akiakane	秋茜
mikeoji	みけおじ
ichien	いちえん
aa	ああ
mirukutanuki	みるくたぬき
kugumaro	くぐまろ
mayurataimu	マユラタイム
shiopan	しおぱん
mahosayu	まほさゆ
kanpaiotoko	乾杯男
kariya	かり屋
kaseiyukimitsu	火星ユキミツ
chiyota	チヨタ
pachirisu	ぱちりす
shin	しん
nira	にら
taka	タカ
emuneko	えむねこ
ninjin	にんじん
ekanamo	えかなも
jun	じゅん
gomadoufu	ごまどうふ
repotama	れポたま
sachi	さち
yajirushi	矢印
akira	あきら
suwapon	スワぽん
asakaachan	アサカーチャン
guren	グレン
inotaku	いのたく
myon	みょん
mameo	まめお
kiyon	きよん
ponko	ぽんこ
noerun	のえるん
kohaku	琥珀
okome	おこめ
kirishima	霧島
marumo	まるも
kabosu	かぼす
izumotori	いずもとり
ikameshi	いかめし
takara	たから
shaga	しゃが
usagiotoko	うさぎおとこ
mirukutanuki	みるくたぬき
ujikintoki	宇治金時
sunarion	スナリオン
otoha	音葉
piyopiyo	ぴよぴよ
kiyora	きよら
senna	千奈
hatena	ハテナ
suzuka	すずか
yanderefujikun	ヤンデレ不二くん
ruria	るりあ
komugi	小麦
niseyousui	偽陽水
yokubariwashika	よくばりワシカ
topia	とぴあ
mahimahi	まひまひ
terako	てらこ
hamutaro	はむたろ
akusa	亜草
yukirin	ゆきりん
ryon	りょん
hitotose	ひととせ
wakita	わきた
meme	めめ
shibagori	しばごり
itan	異譚
annachan	安那ちゃん
ru	る
miko	ミコ
kyousuke	恭介
noraneko	野良猫
rikka	立夏
maron	マロン
min	みん
maju	マジュ
merakana	メラカナ
chiyo	ちよ
rinbuu	リンブー
suzuka	すずか
miyakun	みやくん
tsukinoki	つきのき
tomomi	ともみ
hidemaru	ひでまる
erina	えりな
kotobanomiryoku	言葉のみりょく
kurosagi	くろさぎ
kawasaki	かわさき
daradara	だらだら
zen	禅
henchinsai	変珍齋
gomechan	ゴメちゃん
semi	せみ
kona	こな
ikedamayuko	池田まゆ子
chiruhi	ちるひ
shino	しの
burarin	ぶらりん
asukyun	あすきゅん
yu	ゆ
fuuchan	ふうちゃん
hiiragi	柊
hazuki	葉月
ajitama	あじたま
neomusai	ネオムサイ
aoimanabu	あおいまなぶ
hichan	ひちゃん
dereji	でれじ
inu	いぬ
ariei	ありえい
tokage	とかげ
koya	コヤ
pengin	ぺんぎん
jami	ジャミ
takayan	タカヤン
momose	百瀬
neginegi	ねぎねぎ
naniwamei	なにわめい
takuto	たくと
midore	みどれ
nago	なご
kaneda	かねだ
hiyokonbu	ひよこんぶ
moe	もえ
azu	あず
mochininomaru	もち二の丸
minami	みなみ
ishikun	いしくん
manaka	マナカ
inmakotarou	淫魔小太郎
suzuki	すずき
izaya	いざや
ten	てん
saatan	さーたん
marimo	まりも
suzuta	すずた
yosshi	よっし
ryuuri	劉理
teisui	艇酔
tebasaki	てばさき
watanabetsuneo	渡邉恒雄
nekozamu	ねこざむ
shiina	しいな
tsurugi	剣
nukoneko	ぬこねこ
oragiru	おらぎる
arigataiokotoba	ありがたいお言葉
hanoa	ハノア
danmaru	だんまる
mutsumi	むつみ
hikaru	ひかる
yute	ゆて
momokarin	ももかりん
natsumikan	なつみかん
shin	紳
yono	よの
hinata	ひなた
komatsuna	こまつな
kotora	ことら
raame	らーめ
budou	葡萄
shiromu	しろむ
kawasaki	カワサキ
utakaeru	うたかえる
yoshitomo	よしとも
edomon	江戸モン
mamoru	まもる
yukinohitohira	雪のひとひら
sara	さら
masagami	マサがみ
oiwa	オイワ
aoonikun	青鬼くん
hiyokonbu	ひよこんぶ
garuyama	がる山
monmon	もんもん
moko	モコ
mameruri	まめるり
karuki	カルキ
kukko	くっこ
yukimaru	ゆきまる
shoi	しょい
kujitaso	くじタソ
chiita	ちぃた
kenta	けんた
monakamochi	もなかもち
yamosabo	やもさぼ
shimada	しまだ
nozomi	のぞみ
saon	さおん
uberuri	ウベルリ
kaoru	かおる
koro	ころ
yukinee	ゆきねえ
tsubamemasamune	つばめマサムネ
mahiru	まひる
tenopeno	てのぺの
nigera	ニゲラ
kodama	コダマ
seu	せう
ruu	るぅ
fuura	ふうら
kamimu	カミム
hoshiko	星子
anesan	姐さん
dozounonyaka	土蔵のにゃか
yasuwo	やすを
sano	佐野
okara	オカラ
maguro	まぐろ
masayo	まさよ
usagiinu	うさぎいぬ
kohaku	琥珀
kuruse	くるせ
akakuro	あかくろ
shiki	しき
mutsu	むつ
kamikou	カミコウ
miyuki	美由紀
ria	りあ
mitsuto	ミツト
hiro	ひろ
senba	センバ
ichi	いち
kanon	かのん
haru	はる
yakamashiiyatsu	やかましい奴
asakawaharuha	朝河春葉
marina	まりな
ayasaki	綾崎
soyo	そよ
matsuiao	松井青
kouon	こうおん
momose	ももせ
soramama	そらまま
akiko	あきこ
osatsuneko	おさつねこ
mamiya	間宮
takanasu	たかなす
umemomo	うめもも
anamazu	あなまず
kyokutan	極端
goma	ごま
hiryuu	緋流
tsuini	ついに
minu	みぬ
yasuha	泰葉
pitorin	ピトリン
wako	わこ
myuu	みゅう
younashi	ヨウナシ
rikuton	りくとん
ai	藍
ririko	りりこ
moko	モコ
majiko	まじこ
yunachan	ゆなちゃん
hiroton	ヒロトん
hinata	ひなた
takumi	たくみ
asaitori	麻井鳥
jidouhikki	自動筆記
kaitorisenkou	かいとりせんこう
kazuchan	かずちゃん
konoha	このは
kimura	機村
hisui	翡翠
numayan	ヌマヤン
sorane	そらね
ritsu	りつ
kurumi	胡桃
toma	とま
kumakounohaha	クマ公の母
ugacha	宇賀茶
aiko	あいこ
kabo	かぼ
mio	澪
yana	弥那
nodoka	のどか
karakurikarari	からくりからり
okarin	おかりん
zoronesu	ゾロネス
mahiru	まひる
masaya	まさや
minmon	みんもん
izumi	いずみ
rewasu	れわす
garu	ガル
tori	鳥
mikeru	みける
urakawa	うらかわ
mahiru	まひる
cherin	チェリン
moo	もー
shiroinu	白犬
seragi	せらぎ
kaopon	かおぽん
remu	れむ
iroha	いろは
seto	瀬戸
hamafuto	はまふと
tetsutarou	鉄太郎
yakiniku	やきにく
torihiki	取引
richo	りちょ
kokono	ここの
torao	とらお
mofumofu	もふもふ
okarin	おかりん
maroko	まろこ
maimai	まいまい
haruna	榛名
himawarin	ひまわりん
asumon	あすもん
tomokichi	ともきち
yamamotosan	山本さん
motoka	もとか
marumichan	まるみちゃん
kafemoka	カフェモカ
jiropa	じろぱ
umenomayo	梅ノマヨ
sukima	すきま
kuronoyuu	黒野ユウ
kobataku	こばたく
usagi	うさぎ
era	ぇら
ken	けん
hirari	ひらり
nobuchan	のぶちゃん
shiro	しろ
aika	アイカ
yuzuha	ゆずは
miharu	みはる
kojio	こじお
ikameshi	いかめし
kanninbukuro	堪忍袋
suwa	すわ
yurayura	ゆらゆら
pekekai	ぺけかい
rakuten	楽天
pee	ぺぇ
kiramekishun	キラメキ俊
egao	エガオ
izofeu	イゾフェウ
itsuki	イツキ
shimada	しまだ
kusamizu	くさみず
dereji	でれじ
peko	ペコ
hina	ひな
guredora	グレドラ
kaju	かじゅ
tooru	とーる
mi	み
ayataka	綾鷹
hino	ひの
chidorimanjuu	千鳥饅頭
gonta	ゴン太
kinokoman	きのこまん
wakasagi	ワカサギ
kano	かの
kazu	かず
kuma	くま
minori	ミノリ
tomokun	ともくん
yoruinu	夜犬
koyu	コユ
tamari	たまり
takaeda	タカエダ
kou	こう
komaki	小牧
parukichi	ぱるきち
nimo	ニモ
arufe	あるふぇ
sugichan	杉ちゃん
yomin	よみん
potechi	ぽてち
otatsu	おたつ
mimurokku	みむろっく
takano	たかの
kira	きら
nikumarunikumi	肉丸肉実
kanata	かなた
osoraaka	おそら垢
kawazoemakoto	河添誠
rana	らな
suzaku	すざく
hannarimako	はんなりまこ
karuma	かるま
tokisa	ときさ
kisouma	木曽馬
pyonkichi	ぴょんきち
shiomiku	しおみく
akira	あきら
notane	のたね
ginkochan	ぎんこちゃん
mitahachi	みた八
monmo	もんも
ayanagi	あやなぎ
gurumin	ぐるみん
nagipon	なぎぽん
rikka	立夏
sukeuyu	すけうゆ
perusona	ぺるそな
payapaya	ぱやぱや
shigure	しぐれ
takumaro	たくまろ
watarunrun	わたるんるん
matsuriyakayo	まつりやかよ
yamazakimiho	やまざきみほ
amakusa	あまくさ
katatsu	かたつ
mahiru	まひる
etsu	エツ
yuru	ユル
hinakiku	ひな菊
sakiko	サキ子
taama	たーま
sakirae	さきらえ
shinchibi	しんちび
nachi	なち
mihaji	ミハジ
gajira	がじら
aranmi	アランミ
izumi	いづみ
kazunoko	かずのこ
noriben	のり弁
zerotsuu	ゼロツー
temari	てまり
gura	ぐら
mahiru	まひる
supana	すぱな
kuromame	黒豆
hiroi	ヒロイ
tobimasa	トビマサ
amano	アマノ
kureha	くれは
yosuko	よすこ
woshite	ヲシテ
irotsuka	いろつか
kogepanda	こげぱんだ
tasutai	タスタイ
souichi	そういち
maruhanamone	まるはなもね
chisato	チサト
kajicha	かじちゃ
kocha	こちゃ
etsu	エツ
chon	ちょん
kogepanda	こげぱんだ
aki	あき
asakawarin	朝河凛
shigetechi	しげてち
kimiko	きみこ
hinata	ひなた
yamiko	闇子
hikaru	ひかる
mugimamu	麦まむ
konatsu	こなつ
mikeneko	みけねこ
okoge	おこげ
uradia	ウラディア
borochi	ぼろち
kumori	くもり
rai	ライ
juno	ジュノ
mochi	もち
chimuchimu	チムチム
itaja	いたじゃ
akatomato	赤トマト
hangetsu	はんげつ
kontaku	こんたく
natsu	ナツ
kuremai	くれまい
ayataka	ｱﾔﾀｶ
nanase	ななせ
tatsu	辰
minako	美奈子
nanako	ななこ
saboten	さぼてん
yamapona	やまぽな
someaka	染赤
itemon	いてもん
reifisu	レイフィス
yoshitomo	ヨシトモ
yukemuri	ゆけむり
usanii	ウサニィ
ai	哀
kanisoru	カニそる
momokan	桃缶
kusunoki	くすのき
puratto	プラット
yugi	ゆぎ
yumata	ゆまた
mito	みと
nagaemon	ながえもん
hachi	はち
irise	いりせ
sanagi	さなぎ
ginga	銀河
yamana	やまな
odariku	おだりく
ea	エア
kinoko	キノコ
kinako	きなこ
yuragineko	ゆらぎねこ
akua	あくあ
furan	フラン
nekomiso	ﾈｺﾐｿ
haine	はいね
suzukaken	スズカケン
shieri	しえリ
seto	せと
noraneko	野良猫
achimaru	あちまる
meyu	めゆ
toron	とろん
yamaringo	やまりんご
achan	あちゃん
suiseimeteo	彗星メテオ
ponpin	ポンピン
nai	ない
romio	ロミオ
kazuki	かづき
buren	ぶれん
matsugen	まつげん
toriatama	とりあたま
eruno	えるの
ringamae	りんがまえ
usami	うさみ
hibiya	日比谷
shimotsukisui	霜月彗
kiichi	喜一
orisa	おりさ
obake	お化け
yuuyuu	ゆうゆう
marumo	まるも
utayu	ウタユ
yuukari	ゆーかり
kotaineko	固体猫
akyamaru	あきゃまる
asahi	あさひ
hideka	秀香
nimo	ニモ
urita	うりた
yuusan	ゆうさん
sorakumo	そらくも
kinburisu	キンブリス
nanasemaru	ななせまる
miyu	みゆ
kiharu	キハル
sayo	さよ
kiyobei	きよべい
kuro	クロ
aki	あき
eru	える
nanami	ななみ
orion	オリオン
yukiho	雪穂
sakin	さきん
rio	りお
koroiya	ころいや
harukundau	はるくんだぅ
niwayama	にわやま
saku	さく
tamari	たまり
ayuzakana	あゆざかな
kaitanion	カイタニオン
yuzu	ゆず
goma	ゴマ
marunana	まるなな
satou	砂糖
ojazukin	おじゃずきん
kurumi	クルミ
tanaka	田中
chikako	ちかこ
motokamin	もとかみん
hina	ひな
takakame	タカカメ
tsuyoshi	つよし
harumiya	ハルミヤ
kanedain	カネダイン
harumaki	はるまき
okimono	置き物
shadon	しゃどん
pochi	ぽち
sakura	さくら
umashio	うましお
kobamizawa	こばみざわ
hiiragi	ひいらぎ
yuu	ゆう
serena	セレナ
yukke	ユッケ
romio	ロミオ
nemutamu	ねむたむ
toha	とは
kei	けい
cherimin	ちぇりみん
fumiemon	ふみえもん
kamome	かもめ
tsukamura	ツカムラ
muchi	むち
utakatanohibi	うたかたの日々
mooto	もーと
usa	うさ
shinkai	しんかい
tamari	たまり
miso	みそ
yamana	やまな
yunapon	ゆなぽん
moja	もじゃ
harui	春井
toki	鴇
arakidonsan	あらきどんさん
uzumemai	うずめまい
kenmin	けんみん
kinoko	キノコ
erimaki	えりまき
natsu	なつ
ruke	るけ
oshida	押田
chomo	ちょも
akimiko	あきみこ
atamaru	あたまる
sakurarin	桜凛
inuzen	犬善
nekonomiiko	猫のミー子
mamocha	まもちゃ
sakana	サカナ
kabe	壁
kiaru	きある
date	伊達
yasuzero	やすぜろ
sakuramomo	さくらもも
nemuromai	根室まい
takumi	たくみ
sonohi	ソノヒ
edamamechan	えだまめちゃん
yape	やぺ
yaakun	やーくん
shirasu	しらす
nva	んヴぁ
noma	のま
kaechan	かえちゃん
kakinofu	かきのふ
yayomei	やよめい
yuina	ゆいな
sasanori	ささのり
naruichi	なるいち
marumaru	まるまる
kurechin	くれちん
ikkan	いっかん
riku	りく
yagomasami	やごまさみ
urakiakato	ウラキアカト
ryou	涼
zakurou	ざく郎
okoshi	お越し
pekopon	ペコポン
izuna	いづな
amachirasu	あまちらす
junjun	じゅんじゅん
shihoteri	しほてり
doumoto	どうもと
chibibi	ちびび
mabu	まぶ
yuka	ゆか
himenushi	ひめぬし
setofuumi	瀬戸風味
kobayan	こばやん
wafuyo	わふよ
monmon	もんもん
yanto	やんと
mihokuma	みほくま
makoto	マコト
tekidanhei	擲弾兵
yokako	よかこ
piro	ぴろ
yamaken	やまけん
youhaku	ようはく
sua	すあ
tatsukichisan	たつきちさん
daimajin	大魔人
oumi	おうみ
kurochan	クロちゃん
midorin	みどりん
negitoru	ネギトル
tsukasatan	つかさたん
kikuko	きくこ
io	イオ
peu	ペウ
homutarosu	ほむたろす
datteinugasuki	だって犬が好き
tsurumyon	つるみょん
muku	むく
futaba	ふたば
sakurana	さくらな
sonata	ソナタ
shimotsukisui	霜月彗
itsuki	いつき
kuuhaku	空白
yuki	ゆき
ozuma	おずま
eroneko	エロ猫
yomi	よみ
shinogi	シノギ
bintoro	びんとろ
monea	モネア
pino	ピノ
peu	ペウ
nagatonbosensei	ながとんぼ先生
kabeuchi	かべうち
ryoma	りょま
seiuchi	せいうち
kamemaru	亀丸
takahira	タカヒラ
kou	こう
yumeizumi	夢泉
toyamin	とやみん
mizou	ミゾウ
funatsukazuki	ふなつかずき
ettan	えったん
yuki	ユキ
sakura	さくら
furuken	ふるけん
sakurui	さくるい
shiwara	しわら
ramuu	らむぅ
sansuke	さんすけ
chiitaso	ちぃたそ
shieru	しえる
tatsu	たつ
ohanachan	おはなちゃん
minito	ミニト
rokushin	ろくしん
kaminanoanikiso	カミナのアニ木曾
hirusora	昼空
konomaru	このまる
mikimiki	ミキミキ
natsumi	なつみ
shikito	しきと
minochi	みのち
ruri	るり
raitei	雷帝
kaede	かえで
hiko	ひこ
chama	ちゃま
sango	珊瑚
wakkein	わっけいん
kanakana	かなかな
rino	莉乃
denpainu	でんぱ犬
bunchan	ぶんちゃん
katsuya	カツヤ
yasapen	やさぺん
yukiha	ゆきは
meron	めろん
samasuma	さますま
himako	ひまこ
kurumin	くるみん
yuzupi	ゆづぴ
kocha	こちゃ
motomiya	もとみや
kirin	きりん
shiosu	しおす
yakumo	八雲
harukaze	ハルカゼ
funatsukazuki	ふなつかずき
chiitaso	ちぃたそ
akito	アキト
pori	ぽり
ogeso	おげそ
cherino	ちぇりの
hiro	ひろ
hinatsu	ひなつ
kemeko	ケメ子
tantan	タンタン
morisoba	もりそば
magowasabi	まごわさび
pokara	ぽから
amatori	あまとり
omochi	おもち
yamagaro	やまがろ
pipipopo	ぴぴぽぽ
futabaneko	ふたばねこ
jonma	じょんま
hatori	ハトリ
totemototemo	とてもとても
ruri	るり
shua	しゅあ
kantakko	かんたっこ
ichigo	イチゴ
yomi	よみ
donguma	どんぐま
nekounako	ねこうなこ
charo	ちゃろ
okomeman	オコメマン
kogurekaneto	こぐれかねと
nekota	猫田
yuu	侑
isei	井静
kojipan	こじぱん
natsusame	夏鮫
kaniko	かにこ
kume	くめ
yuttan	ゆったん
yarikomitaro	槍混み足ろ
tarabe	たらべ
mayuri	マユリ
kazamineko	風見猫
yosua	ヨスア
orenju	おれんじゅ
nekoko	ねここ
mai	まい
mokiji	もきじ
kenesu	ケネス
yoshizawa	よしざわ
torabe	トラベ
ankoromochi	あんころ餅
orukun	おるくん
hararudo	ハラルド
mune	むね
shirosuke	しろすけ
nasso	なっそ
sapposapo	サッポサポ
kakichoko	柿チョコ
katari	かたり
haruno	はるの
kouon	こうおん
myuuto	みゅーと
tsugu	つぐ
kuroyagi	くろやぎ
miroku	みろく
hogahoga	ほがほが
kaede	かえで
suna	すな
kazu	カズ
masuki	ますき
sekia	せきあ
yochomo	よちょも
shirasu	しらす
miyafuji	みやふじ
hayanedentou	早寝電灯
kitsuneudon	きつねうどん
bossan	ぼっさん
rumomomo	るももも
jion	じおん
echimayo	えちマヨ
nanochi	なのち
ao	蒼
torihiki	取引
izuna	イズナ
yunamaro	ゆなまろ
kupo	クポ
kichiku	きちく
hotoke	ホトケ
sukumichan	スクミちゃん
buripan	ブリパン
terucha	てるちゃ
michinekorubea	みち猫ルベア
saratoga	沙羅咎
shirupiyo	しるぴよ
shinjirou	シンジロウ
kotenofuko	コテノフコ
kako	かこ
pokemonia	ポケモニア
hyou	ヒョウ
rito	りと
nanmoku	なんもく
miichope	みーちょぺ
dokkanosouta	どっかのそうた
shiwara	しわら
hitsujisan	羊サン
gurimoe	ぐりもえ
fumi	ふみ
nenu	ねぬ
satoken	さとけん
hayamamoka	葉山もか
ahi	あひ
kaninkanshoku	完飲完食
kirimisakana	切身魚
ajisan	鯵さん
noriyuki	ノリユキ
uimamakawaii	ういままｶﾜｲｲ
uro	うろ
kaede	かえで
furifuri	フリフリ
maguro	まぐろ
paranosu	ぱらのす
iruru	イルル
yuzuha	ユズハ
menherachan	メンヘラちゃん
medama	めだま
suzume	すずめ
aki	秋
zakiyama	ザキヤマ
yakezake	やけざけ
chanchan	ちゃんちゃん
kaya	カヤ
mako	まこ
piyopiyo	ぴよぴよ
kimurataku	木村拓
sayamasashi	さやまさし
aoitori	青い鳥
ottotto	おっとっと
nepudo	ネプド
tetsuma	てつま
mawaru	まわる
kisaragirai	如月らい
mashiro	ましろ
surawaki	すら脇
aratapi	あらたぴ
tonikaku	兎に角
akotato	あこたと
yaminoshinshi	闇の紳士
anzensokusen	あんぜんそくせん
akite	あきて
yuuka	ゆーか
oyasai	おやさい
bakon	ばこん
kyatto	キャット
nene	ねね
minbuta	みんぶた
ruto	ると
emuchi	えむち
miya	みや
kuroageha	クロアゲハ
sora	空
watarishirou	渡志郎
momoha	ももは
mikannya	みかんにゃ
oyakoukounohibi	親孝行の日々
shio	しお
teke	てけ
tamaki	たまき
kisakuma	きさくま
sayo	さよ
kanoesaruya	カノエサルヤ
hakumu	はくむ
tamamo	玉藻
yurika	ユリカ
koppa	こっぱ
uraken	うらけん
utaake	うたあけ
umasaru	ウマサル
araya	アラヤ
koukun	こうくん
shishidomisora	宍戸美空
hagakikatteren	ハガキ勝手連
nasu	なす
rekkahin	劣化品
mainichihigoto	毎日日毎
peto	ぺと
kuro	黒
nanitaka	なにたか
ponkichi	ぽんきち
darakkuma	だらっくま
nerizou	ねりぞう
ikameshi	烏賊飯
chitoremon	ちとレモン
keishinosuke	けいしのすけ
sharu	しゃる
nyahotama	にゃほたま
negishio	ねぎしお
tsubasa	つばさ
saki	さき
kouhei	こうへい
nasuno	なすの
hiro	ヒロ
shiiton	しいとん
tanuki	たぬき
nato	なと
yuyuyu	ゆゆゆ
panmii	ぱんみぃ
kamakashi	鎌菓子
hideto	秀人
rate	らて
nekojii	猫爺
yoru	夜
rokuro	ろくろ
sameda	さめだ
minimamu	みにまむ
kankitsu	かんきつ
hiiragiusagi	柊兎
miyano	みやの
kazu	カズ
rin	りん
pono	ぽの
haru	はる
kodokunopan	孤独のパン
akiakane	秋茜
irohasu	いろはす
ogatake	オガタケ
kiki	キキ
kazuki	かずき
rioooo	りおおおお
kirin	きりん
ginnosuke	ぎんのすけ
yura	ゆら
amaharu	あまはる
minzono	みんぞの
hatchan	はっちゃん
atsuki	あつき
kuroneko	くろねこ
masane	まさね
sena	せな
nukoyan	ぬこやん
hinadon	ひなどん
tobari	トバリ
homura	ほむら
maa	まあ
gaia	ガイア
tamagonokimi	たまごのきみ
yukino	ゆきの
minori	みのり
maa	まあ
ron	ロン
basashi	ばさし
takayamaimoshi	たかやまいもし
fugajin	ふがじん
amasora	あまそら
henchinsai	変珍齋
yuuyuu	優優
okunotakako	奥野たかこ
shion	ｼｵﾝ
ibuki	伊吹
takamura	たかむら
itsuban	逸番
mayumi	まゆみ
nyutto	にゅっと
niboshi	にぼし
nuta	ぬた
miyuna	みゆな
kanra	かんら
pochinan	ぽちなん
tanakachan	田中ちゃん
kozarukiyu	こざるきゆ
hiromu	ひろむ
shinku	シンク
nerunga	ネルンガ
byakuya	白夜
okaka	おかか
natsuna	ナツナ
sunuko	すぬこ
kinkankonatsu	きんかんこなつ
toyotaka	とよたか
kurobuchi	クロブチ
kikumaru	菊丸
mizuki	ミズキ
rai	らい
suppon	すっぽん
komakomasentai	狛狛戦隊
shirohan	しろはん
hayasemegumi	早瀬めぐみ
shirounagi	白ウナギ
hakua	白亜
yukisai	ゆきさい
mikuru	みくる
yuyuyu	ゆゆゆ
atsuyan	あつやん
akatan	あかたん
yuzu	ゆず
kappa	河童
nanohana	ナノハナ
ruri	るり
murata	村田
tabiken	たびけん
gorou	ゴロウ
ton	トン
karu	かる
runayarou	ルナ野郎
hariguwa	はりぐわ
nayuta	那由多
kiraku	きらく
eku	えく
kusaka	くさか
yukishita	雪シタ
hiyori	日和
amiborara	アミボララ
manimanidango	まにまに団子
takkun	たっくん
kikyou	ききょう
tatehito	たてひと
unipen	うにぺん
asayuri	あさゆり
ishida	いしだ
shotagoe	ショタゴエ
sousuke	荘介
akaringoame	あかりんごあめ
janjimu	じゃんじむ
haruko	はるこ
itefuna	イテフナ
hoshimin	ほしみん
ichi	いち
togashita	トガシタ
shimahijiki	島ひじき
fumi	ふみ
niboshi	にぼし
otokonokonote	男の子の手
kekedosun	けけどすん
yamada	山田
kanasubi	かなすび
gofuku	五福
tegamisha	手紙社
hemyutan	へみゅたん
miihipen	ミイヒペン
kanji	漢字
hizumitouga	ヒズミトウガ
kanten	かんてん
gonta	ごんた
yakiniku	焼肉
momohama	ももはま
kitahajime	キタハジメ
rei	れい
arisawasan	有澤さん
hoshiko	星子
hatoage	ハトあげ
ninonino	ニノニノ
kusadangotarou	草団子太郎
nabeyan	なべやん
tereko	てれこ
nemunashi	ねむなし
kiato	きあと
kaepyon	かえぴょん
hanma	ハンマ
katsumaji	かつまじ
ringo	りんご
yuuri	悠莉
gankichi	がんきち
yuguri	ゆぐり
hiroaki	ヒロアき
sachin	さちん
sanseberia	さんせべりあ
dodo	どど
zakuro	ざくろ
oshiruko	おしるこ
iwakugi	イワクギ
misae	みさえ
ramia	ラミア
kurumi	胡桃
oze	尾瀬
ranmaru	蘭丸
tamagomarumain	たまごまるまいん
woppochan	ヲっぽちゃん
kiyobei	きよべい
tamagodaisoutou	卵大総統
tankeshi	たんけし
mannenbinetsu	万年微熱
nodoka	のどか
kamisugipon	かみすぎぽん
yoshino	ヨシノ
tamagosando	たまごさんど
yoshino	ヨシノ
mameto	まめと
hidaka	ヒダカ
fejo	ふぇじょ
ayame	アヤメ
kerokero	けろけろ
aochin	あおちん
tsuruki	つるき
garakuta	がらくた
aochin	あおちん
yuya	ゆや
kiyo	きよ
yoshidahideo	吉田秀雄
pime	ぴめ
asahine	アサヒネ
zunda	ずんだ
nekomata	猫又
shiori	しおり
izumi	いずみ
non	のん
gorogoro	ゴロゴロ
matsunari	まつなり
hi	ヒ
umino	海乃
nanami	ななみ
sensouya	戦争屋
kaoru	かおる
kurokamimeido	黒髪メイド
mozuku	もずく
takekiyo	たけきよ
miyanishiminoru	みやにしみのる
fucha	ふちゃ
hikahiro	ひかひろ
ayacha	あやちゃ
saginomiya	さぎのみや
sana	サナ
tehepero	てへぺろ
momokarin	ももかりん
nishitama	にしたま
ozumajo	オズマジョ
ohagimochi	御萩餅
makuramochi	まくらもち
izumi	いずみ
fukutarou	ふくたろう
sabanana	サバナナ
mebiaru	メビアル
damanao	だまなお
yamamoto	やまもと
kaede	かえで
chiharukumu	千春クム
moiroroto	モイロロト
rutea	ルテア
takana	タカナ
mitsuki	みつき
pekekai	ぺけかい
ireina	イレイナ
takuri	たくり
satoumakura	さとう枕
akesan	あけさん
esu	えス
kabisushi	カビ寿司
azusa	あずさ
nozoshi	のぞし
rearu	れある
kouki	こうき
satoshi	さとし
yamiyami	ヤミヤミ
zen	禅
omusubi	おむすび
matton	まっとん
mitsuha	蜜葉
oyaneko	親猫
kawacho	かわちょ
papiko	ぱぴこ
noki	のき
puricha	ぷりちゃ
ozounikan	お雑煮缶
ritsu	リツ
minagi	みなぎ
chacha	茶々
chumi	ちゅみ
sanmakoushiki	さんま公式
sensouya	戦争屋
yutao	ゆたお
semirenai	せみれない
ayame	あやめ
rokuchan	ろくちゃん
kinupaseri	絹パセリ
katakurigo	かたくりご
kuroro	くろろ
ajipon	あじぽん
pontenton	ぽんてんとん
bunbun	ぶんぶん
nekomata	猫又
konkue	こんくえ
miyamura	宮村
hagehagechabin	はげはげちゃびん
donchan	どんちゃん
satoko	里子
yamia	闇亜
ichimura	壱村
maehoma	まえほま
momu	もむ
kaseiteiou	火星帝王
kanata	彼方
ageha	あげは
mirin	みりん
derasan	でらさん
rita	リタ
kuririn	くりりん
kamaboko	かまぼこ
amashirokanata	あましろかなた
haume	葉梅
barugurio	バルグリオ
ayato	ｱﾔﾄ
namurun	なむるん
kamichu	かみちゅ
toriman	トリマン
tanatosu	たなとす
izumi	いずみ
buzamasu	ブザマス
fusachan	フサちゃん
suwapon	スワぽん
chibu	チブ
nao	なお
rokua	ろくあ
chie	ちえ
kuronoya	黒乃屋
rencha	れんちゃ
natsumi	なつみ
anzusuika	杏彗架
mihha	みっは
nachi	那智
ryocha	りょちゃ
marobashi	まろばし
mege	めげ
sakurahina	桜雛
gaisensasayan	ガイセンササヤン
kaki	柿
sasami	ささみ
uteki	うてき
ajaku	アジャク
azuru	アズル
kawakamiminoru	川上稔
muku	椋
machiro	まちろ
muruko	むるこ
pachuru	ぱちゅる
yuzuna	ゆずな
nanakiri	ななきり
noraneko	のらねこ
hahaku	ははく
kon	こん
mimikkyu	みみっきゅ
kinkin	キンキン
akihime	あきひめ
hochiya	ほちや
himagine	ヒマギネ
maro	まろ
umi	うみ
masao	まさお
rui	ルヰ
chiyu	ちゆ
myuu	みゅう
konnyakuu	こんにゃくぅ
koko	ここ
kiruru	キルル
mayuki	まゆき
mamiya	間宮
kyousuke	恭介
nino	にの
moribuden	モリブデン
nishitama	にしたま
riya	りや
noyo	のよ
jou	じょう
hideyuki	ひでゆき
nyakurupo	にゃくるぽ
degimono	デギモノ
ayahira	あやひら
haraheriookami	腹減り狼
saki	咲
totoyukkuri	ととゆっくり
makinoatorie	マキのアトリエ
nagu	なぐ
ogi	オギ
muranotanuki	村野狸
nenne	ねんね
touta	とう太
mukuron	ムクロン
nagisa	なぎさ
matsubokuri	松ぼくり
yuyurori	ゆゆロリ
tegurasu	てぐらす
rimuru	リムル
ayu	アユ
araran	あららん
mayapi	まやぴ
kouji	工事
otetetsunaide	お手てつないで
ninnikuman	ニンニクマン
burushi	ぶるし
mozukuzu	もずくず
kuisa	クイサ
saori	沙織
nozomi	のぞみ
samekichi	さめきち
kaki	かき
takenami	タケナミ
reika	れいか
pippi	ぴっぴ
touya	とうや
daimaru	だいまる
moba	もば
nyapi	にゃぴ
takakame	タカカメ
sakuhyon	さくヒョン
urakaba	裏かば
kana	かな
sakurasora	桜空
satou	佐藤
shiro	シロ
nonsan	のんさん
mikan	みかん
runa	ルナ
kanatsuki	カナツキ
etsu	エツ
harachan	はらちゃん
yukinousagi	雪野うさぎ
hisora	ひそら
ukimo	うきも
yukinko	ゅきんこ
yuka	ゆか
fumie	ふみえ
komasan	コマさん
kiridarukyan	きりだるきゃん
mugonkun	むごんくん
saaya	さぁや
harameruko	はらめるこ
suzu	珠洲
saachan	さーちゃん
nyarumaru	にゃる丸
maikuyasu	マイクヤス
aotomoko	青智子
sao	さお
chisaki	ちさき
hassan	ハッサン
miyochi	みよち
naisekisha	ないせきしゃ
nozaki	のざき
kanako	かなこ
kanon	かのん
hana	はな
uno	うの
fuwafuwanokuma	ふわふわのくま
goro	ゴロ
ayaya	あやや
kanadekun	かなでくん
satake	さたけ
yoruageha	夜アゲハ
rui	るい
idea	イデア
kaminokami	紙の紙
donguri	どんぐり
riru	りる
makuro	まくろ
taisei	たいせい
narunaru	なるなる
mutsuki	むつき
ankoromochi	あんころもち
kokkoyama	こっこ山
ayaya	あやや
amaki	あまき
okome	お米
yakkuru	やっくる
marin	マリン
jigoku	じごく
aika	アイカ
mutsuko	ムツ子
ruha	るは
akua	あくあ
mochidori	もちどり
saboten	さぼてん
sagaruya	さがるや
memento	めめんと
fate	ふぁて
tetora	てとら
ogimasahiro	小城マサヒロ
sanseberia	さんせべりあ
hazukimichiru	葉月ミチル
kaatan	カータン
kasuga	かすが
samo	さも
horiyasu	ホリヤス
mitsubachi	みつばち
karara	カララ
karoyaka	かろやか
torami	とらみ
aomi	あおみ
watarou	わたろう
kopyota	こぴょた
aozoraneko	青空ネコ
kankitsu	柑橘
uhyu	うひゅ
ruina	るいな
bono	ぼの
pohe	ぽへ
semirenai	せみれない
kurohoro	黒袰
nanaonao	ななおなお
kon	こん
yumiyumi	ユミユミ
aokidekiseki	青黄でキセキ
ramu	らむ
yoko	ヨコ
kiwamochi	きわもち
subarun	すばるん
keikaten	経過点
kurume	くるめ
yukichan	ゆきちゃん
abe	あべ
tsuno	つの
hikikomori	弾きこもり
kiria	霧亜
kanon	かのん
mizutama	みずたま
nekonote	ねこのて
himechan	ひめちゃん
maiko	まぃこ
maruhigeya	マルヒゲヤ
iori	伊織
shironoe	しろのえ
hinabon	ひなぼん
kairi	かいり
rinonriumu	りのんりうむ
kousakukoubou	工作工房
ikayaki	イカ焼き
aisu	アイス
montan	モンタン
yumiyumi	ユミユミ
natsuyoshi	なつよし
uzaki	宇崎
hirori	ひろり
suzunun	すずぬん
kujiraishi	くじら石
baradagi	ばらだぎ
kosato	こさと
misaki	みさき
nekotora	ねことら
sesuna	せすな
ariei	ありえい
aika	あいか
suzuki	すずき
himakami	暇神
inufugu	いぬふぐ
run	るん
herohero	へろへろ
chigu	チグ
tami	たみ
nozaki	のざき
uuchan	うーちゃん
kururinu	くるりぬ
amyu	アミュ
sarun	さるん
yuno	ゆの
rurushiro	るるしろ
shinano	しなの
hitsujisan	羊サン
hanachan	はなちゃん
momote	ももて
hinakuma	ひなくま
hanimaru	はにまる
maru	まる
runa	るな
hakua	白亜
unagiya	うなぎや
ariei	ありえい
yadon	ヤドン
hamunagashi	ハムながし
ginga	銀河
honegai	ホネガイ
mura	ムラ
mirin	みりん
kinoga	キノガ
ruikun	るいくん
ponzu	ぽんず
yamiko	闇子
piyokichi	ぴよきち
kenmin	けんみん
harusato	はるさと
yuyu	ゆゆ
wataku	わたく
bobu	ボブ
mayuge	まゆげ
nayu	なゆ
furakushinasu	フラクシナス
aoiro	あおいろ
hanamomo	花桃
shimotsuki	しもつき
mirin	みりん
den	でん
anko	あんこ
hanabie	花冷
miu	みう
iwashi	いわし
tomoichi	ともいち
mirahato	みらはと
arufe	あるふぇ
irohasu	いろはす
noharapiroshiki	野原ぴろしき
gigi	ギギ
wahi	ワヒ
wakuwaku	わくわく
mogura	もぐら
renamaru	れなまる
amapen	アマペン
maki	まき
seo	せお
shimazuyoshirin	島津よしりん
shion	シオン
buntaka	ブンタカ
nanakoma	ななこま
uronkumo	うろんくも
muiko	ムイコ
maikun	マイ君
koumei	コウメイ
takenoko	たけのこ
hyou	ヒョウ
kurenaizukin	紅ずきん
kiriri	きりり
arisan	ありさん
kururinu	くるりぬ
anamenchan	アナメンちゃん
masosan	まそさん
na	な
nyan	ﾆｬﾝ
marumo	まるも
sanae	さなえ
kanami	かなミ
abarabou	あばらぼぅ
nero	ねろ
nankotsu	なんこつ
dotama	どたま
shiratamako	白玉粉
koronbu	コロンブ
daisanmurabito	第三村人
maruko	まるこ
inufugu	いぬふぐ
konami	こなみ
rion	りおん
yakotaki	やこたき
mako	まこ
akari	あかり
uraakajoshi	裏垢女子
kyari	きゃり
nouchirasu	のうちらす
sakuramori	桜森
asain	アサイン
yukinoshibari	ユキノシバリ
oyamada	小山田
aoto	蒼斗
kiki	キキ
inorinokotoba	祈りの言葉
yano	やの
raito	ライト
tebasaki	てばさき
nezumi	ねずみ
yuzumitsu	ゆずみつ
tokumoto	徳本
kani	カニ
ayato	ｱﾔﾄ
mana	まな
utatane	うたたね
ouka	桜花
reo	レオ
himawari	向日葵
miru	ミル
yano	やの
toratora	とらとら
fuuko	ふーこ
kunore	くのれ
arumu	アルム
tobihaze	トビハゼ
reina	麗奈
gero	ゲロ
kaatan	カータン
mui	むい
amanatsu	甘夏
udonkitsune	うどんきつね
ichiya	いちや
renren	れんれん
yamagu	やまぐ
shizuki	シヅキ
ikatake	いかたけ
panakesuta	パナケスタ
ramune	ラムネ
mofunataru	モフナタル
mii	ミイ
megane	めがね
tentama	てんたま
satomi	さとみ
takana	たかな
mume	むめ
inemuri	いねむり
mitsuki	みつき
rinbuu	リンブー
kikusuke	きくすけ
komotomeiko	こもとめいこ
hatsuseshiwasu	初瀬師走
ponkotsu	ぽんこつ
haikan	ハイカン
hinokichi	ひのきち
nerarura	ネラルラ
harekumo	ハレクモ
hikaraito	ひからいと
amefurinojiji	雨降りのジジ
yuki	ゆき
marokun	まろ君
inutaka	いぬたか
taka	鷹
iwashi	イワシ
sakaki	さかき
reo	レオ
vin	ゔｨﾝ
katonbo	かとんぼ
kana	かな
hisokuro	ヒソクロ
sagoman	さごまん
kamerian	カメリアン
sora	そら
kobataku	こばたく
nemu	ねむ
baru	ばる
mii	みぃ
hiyoko	ひよこ
natsumi	なつみ
tenteidaigongen	天帝大権現
taa	たあ
masa	まさ
seikochan	聖子ちゃん
mayu	まゆ
takkun	たっくん
chun	ちゅん
katayama	片山
kinkin	キンキン
saenaisuugakuto	冴えない数学徒
karun	かるん
yassan	やっさん
mika	みか
urumasa	ウルマサ
ferinowaki	フェリの脇
oyasai	お野菜
minatsu	みなつ
yukiyanagi	雪やなぎ
nono	のの
hirokazu	ひろかず
honegai	ホネガイ
sato	さと
saita	さいた
yukkin	ゆっきん
hisanori	ひさのり
tepecha	てぺちゃ
ponkotsu	ぽんこつ
hata	ﾊﾀ
akochi	あこち
kuma	くま
yuriemu	ゆりえむ
yuno	ゆの
terakkuma	てらっくま
haku	ハク
yoi	よい
agu	あぐ
onigirimaru	おにぎり丸
bibia	びびあ
takeyuki	たけゆき
chikataso	ちかたそ
rui	ルヰ
yoshimin	よしみん
kagerou	かげろう
kinopi	きのぴ
pika	ピカ
uta	うた
mishi	みし
potepokari	ポテポカリ
busunako	ブスな子
amuma	あむま
yuuki	ゆうき
airin	あいりん
kumotsu	くもつ
upopoi	うぽぽい
yussan	ゆっさん
hiroshi	ひろし
surea	スレア
mirakuru	みらくる
kouta	こうた
chuparu	ちゅぱる
nayuta	なゆ汰
sangon	さんごん
punimoka	ぷにモカ
iwaton	いわとん
sankichi	さんきち
yunyun	ゆんゆん
ameyuru	あめゆる
nagitawa	なぎたわ
saimaru	さいまる
akane	あかね
nachan	なちゃん
nyoromaso	にょろまそ
kei	慧
kirakorokakera	キラコロカケラ
wakkue	わっくゑ
tachikoba	タチコバ
satoshi	サトシ
koron	ころん
monomoai	ものモアイ
koharu	小春
miyu	みゆ
chan	ちゃん
minekochan	みねこちゃん
gaso	がそ
ebi	えび
koutetsukyou	鋼鉄狂
miu	みう
rui	るぃ
homuotaku	ほむオタク
pipu	ぴぷ
marumichan	まるみちゃん
tomoichi	ともいち
maho	まほ
hiroron	ヒロロン
masarun	まさるん
ukigumotei	浮雲亭
hanada	はなだ
otsuko	おつこ
beko	べこ
kiritore	きりとれ
rei	レイ
wataberu	わたべる
animeanteiku	アニメあんていく
ebichiri	エビチリ
soruto	そると
nanane	ななね
yamamaru	やままる
ayanon	あやのん
nemuta	ねむた
inabaoden	因幡おでん
mon	もん
pite	ピテ
poshi	ぽし
pobeyama	ぽべ山
taneatsu	タネアツ
suzune	すずね
zono	ぞの
nishiyama	西山
okusamansa	奥様んさ
uosuke	うおすけ
mimiyo	みみよ
nomizuiori	野水伊織
namio	なみお
yuri	ゆり
riria	りりあ
rikka	立夏
keika	けいか
konnoran	紺野ラン
yuyuyu	ゆゆゆ
kouki	コウキ
hikaru	ひかる
sendai	せんだい
teringo	てりんご
natayumi	鉈弓
toinosuke	といのすけ
makeo	まけお
maru	まる
gimei	偽名
riichi	りいち
kanaetai	叶え隊
tsuru	鶴
dorandoran	どらんどらん
momochimomo	ももちもも
nannekosan	なんねこさん
matsuko	まつ子
yukimi	雪見
satomi	さとみ
mikonosu	ミコノス
sanpo	さんぽ
yuzumin	ゆずみん
tomomi	ともみ
rakuten	楽天
itsuki	イツキ
moemi	もえみ
kyuuri	キュウリ
saji	沙慈
momochimomo	ももちもも
kitakoma	キタコマ
yuri	ゆり
takimoto	たきもと
aoba	青葉
cheripoyo	ちぇりぽょ
toki	鴇
tatsuhiro	タツヒロ
ren	れん
mashimaro	ましまろ
hamatani	濱谷
yutokei	湯時計
yamashiro	山城
nanase	ななせ
miyuemon	みゆえもん
wao	わお
manoru	マノル
hyamio	ヒャミオ
ogyaiku	オギャイク
matsunoumi	まつのうみ
kuusatsuaki	空撮あき
akasa	あかさ
pime	ぴめ
nayama	なやま
hirari	ひらり
charo	ちゃろ
kanchobi	かんちょび
ayako	アヤコ
mei	めい
sechi	せち
kaori	かおり
rannosuke	らんのすけ
tomoko	とも子
nevin	ネヴィン
sanamaru	さなまる
ranobe	らのべ
shironku	しろんく
kurage	海月
tomaranbou	とまらん棒
rikakochama	りかこちゃま
arutedon	あるてどん
takkun	たっくん
matsume	まつめ
tobirou	とびろう
kaeruman	かえるまん
noi	のい
daraku	駄楽
soukai	ソウカイ
reo	レオ
chanbo	ちゃんぼ
inu	いぬ
yurinotomo	百合の友
yamashin	やましん
kurokumanidaime	黒熊二代目
yukinyanko	ゆきにゃんこ
chihare	ちはれ
kakiihiro	柿井ヒロ
nekoma	ねこま
amamizu	雨水
rokio	ろきお
nana	なな
shimiken	しみけん
youhei	洋平
hekihara	碧原
popotannogeboku	ぽぽたんの下僕
iichiko	いいちこ
omu	おむ
sakura	さくら
raku	ラク
kuru	くる
otakaradouga	おたからどうが
gensan	げんさん
towa	とわ
ereusu	エレウス
yamashin	やましん
shironku	しろんく
ikesaki	いけさき
rinatsun	りなつん
kaminage	紙投げ
kame	カメ
maruchan	まるちゃん
nohama	のはま
takosensei	タコ先生
akira	あきら
haruko	はるこ
nanamaru	那奈丸
kidaruma	きだるま
aoi	あおい
ren	廉
nakinokaeru	哭きの蛙
miyao	みやお
achan	ｱﾁｬﾝ
hiromu	ひろむ
chiida	ちいだ
kito	きと
shiroarikuina	白蟻くいな
pani	ぱに
riruriru	りるりる
hakaranya	はからん屋
okyana	おきゃな
kusa	草
taka	たか
karu	カル
fuwafuwanokuma	ふわふわのくま
mochineko	もちねこ
ayanon	あやのん
takayan	たかやん
paisen	パイセン
koashi	こあし
nonki	のんき
hakuino	はくいの
koruto	こると
naida	ないだ
hane	はね
menchan	めんちゃん
upopoi	うぽぽい
kurosana	クロサナ
harumaki	はるまき
norimaki	のりまき
uyuchan	うゆちゃん
yokubariwashika	よくばりワシカ
naru	なる
uraniwa	裏庭
ringo	りんご
nugayan	脱がやん
shinshin	しんしん
aishun	あいしゅん
pii	ぴぃ
yuuki	ゆうき
yoshimoto	ヨシモト
shibuchin	しぶちん
daken	だけん
aineko	愛ねこ
kimaguren	気まぐれん
tsugumi	ツグミ
minato	湊
robinmama	ロビンママ
toraji	とらじ
oku	オク
kusa	くさ
dainisekaki	第偽柿
aporo	あぽろ
toriko	トリコ
yomino	よみの
tetona	テトナ
yuzukun	ゆずくん
yutchan	ゆっちゃん
yahiro	やひろ
shiyu	しゆ
koike	こいけ
myuu	みゅう
saatan	さーたん
rukibe	ルキベ
urichisa	うりちさ
nanase	ななせ
natsumi	ナツミ
eiroku	永禄
tenjiku	てんじく
ajisai	紫陽花
samekichi	さめきち
taki	タキ
obi	おび
yupi	ゆぴ
sonjo	そんじょ
mizukichi	みずきち
aburatani	油谷
anoai	あのあい
shinoge	シノゲ
teriyaki	てりやき
modahyo	もだひょ
yukidaruma	ゆきだるま
asahi	旭
gansan	がんさん
higu	ひぐ
kuma	くま
momousagi	桃うさぎ
azuki	あずき
takumizumu	タクミズム
sui	スイ
kamaboko	かまぼこ
urawamaru	うらわまる
nike	ニケ
teto	テト
roa	ロア
techiko	てちこ
kurorofiru	クロロフィル
pina	ぴな
tsumepan	つめぱん
nanikato	なにかと
udon	うどん
josui	如水
yuyuya	ゅゅゃ
riu	りう
kisaragirin	如月凛
tengu	天狗
reion	レイオン
ookami	オオカミ
yukimoto	ゆきもと
haamuu	はぁむぅ
ezohoi	蝦夷ほい
sana	沙奈
mobushi	もぶ氏
miisa	みーさ
yuzushiba	ゆず柴
ren	れん
hotaru	蛍
myokyoto	みょきょと
masu	ます
ayamon	あやもん
gansan	がんさん
monaka	もなか
mi	み
manamin	まなみん
kojima	コジマ
nagii	なぎぃ
kei	けい
muzan	むざん
motogashi	もとがし
eiroku	永禄
kerokero	けろけろ
sora	空
hajimomiji	はじもみじ
yamato	やまと
nanahoshi	ななほし
yukimaru	雪丸
sasawaki	ささわき
mimi	みみ
zandan	残弾
mai	まい
mokamoka	モカもか
kozuro	こずろ
yumenomiyoko	夢野みよこ
akkii	あっきー
harekumo	ハレクモ
yukipien	ゅきぴぇん
kiba	キバ
banicha	ばにちゃ
shiba	柴
sanmakoushiki	さんま公式
ganma	がんま
sukotonkotsu	すことんこつ
hanaran	はならん
kazukimaguro	かずきマグロ
ebi	えび
amanouchiraku	あまのうちらく
penpen	ペンペン
ayuki	あゆき
tamutamu	たむたむ
yaja	ヤジャ
mion	ミオン
ori	オリ
sudachi	すだち
pirohiko	ピロ彦
namahage	ナマハゲ
oha	おは
eromoarorisu	エロモアロリス
nana	なな
kinta	きんた
izuna	イズナ
ponta	ぽんた
reibo	れいぼ
fuji	フジ
rarara	ららら
missaa	みっさー
josui	如水
hakuzasa	はくざさ
haniha	はには
noimi	のいみ
yasapen	やさぺん
yama	やま
yuunagi	夕凪
kumanoa	くまのあ
yuzuki	柚樹
aporon	あぽろん
ryuuji	リュウジ
totomarukun	トトまる君
yoshimon	よしもん
arashi	あらし
morimo	モリモ
buri	ぶり
konayuki	粉雪
yabaihato	やばいハト
hachi	はち
mikaru	ミカル
honnoippo	本の一歩
matcha	まっちゃ
naroaki	なろあき
yosetsu	ヨセツ
maromi	マロミ
rui	るい
yukimaru	ゆきまる
ruashi	るあし
riku	りく
mayokara	マヨから
kuraji	くらじ
kadode	門出
shion	紫苑
kuma	くま
aoba	あおば
pon	ポン
kurumiichigo	くるみいちご
nemumimamire	ﾈﾑﾐﾏﾐﾚ
kayama	香山
nagitaru	なぎたる
mainyan	まいにゃん
goeji	ごえじ
meitetsu	めいてつ
onigumo	おにぐも
sabamiso	さばみそ
penpen	ペンペン
chiri	チリ
akimanta	あきまんた
shinya	シンヤ
yuukishan	ゆうきしゃん
yakitori	やきとり
kuniyata	くにやた
riku	りく
aokiyoshiaki	青木義明
naoyako	なおやこ
mokotsu	モコツ
pinkuma	ピンク魔
pue	ぷえ
usappi	うさっぴ
mitomotakako	ミトモタカコ
kikokiko	きこきこ
shintomo	しんとも
roi	ロイ
keko	けこ
shisomihashi	しそみはし
nokonoko	のこのこ
imamu	いまむ
kujira	くじら
amaebi	あまえび
kuro	クロ
nene	ネネ
yatarou	弥太郎
takoyaki	たこやき
teruyaki	てるやき
hatena	はてな
noru	のる
mitsubanki	みつばんき
akapan	あかぱん
moriko	もりこ
kusunoki	くすのき
chachamaru	茶々丸
osushinotomomi	お寿司のともみ
kaori	カオリ
mayunosuke	まゆのすけ
mizuhin	みずひん
nori	糊
atara	あたら
yasutoshi	やすとし
rayuse	らゆせ
meriburu	めりぶる
sakimiya	さきみや
riumu	リウム
kagura	かぐら
zenri	善利
mirubau	ミルバウ
yuria	ユリア
toriri	とりり
mayo	まよ
miyachi	みやち
tokatoka	とかとか
karen	かれん
yurika	ゆりか
masawo	まさを
norakuro	のらくろ
rina	りな
yama	やま
tanukihakase	狸博士
yaminabekaosu	闇鍋かおす
kohaku	琥珀
kiraku	きらく
aaaaa	あああああ
yuudai	ゆーだい
sanayu	さなゆ
honokago	ほのかご
kirisuma	キリスマ
poichan	ポイチャン
harigahara	はりがはら
kuramoto	くらもと
daikyojin	大巨人
yuno	ゆの
sasakidon	ささきどん
yamapiro	山ピロ
himamari	ひままり
aoitaku	あおいたく
apopo	アポポ
fumiaki	ふみあき
sunaonanao	ｽﾅｵﾅﾅｵ
asuka	あすか
iijikanazawa	いいじ金沢
namenama	ナメなま
kaien	カイエン
mika	みか
harumari	はるまり
kage	かげ
takase	高瀬
michitora	道虎
sanroku	さんろく
karakiringo	からき林檎
surumementaiko	するめめんたいこ
gorasupo	ごらすぽ
kuraryu	くらりゅ
arikawakoba	有川古葉
moriri	もりり
ken	けん
soora	そぉら
yuki	ゆき
honoka	ほのか
paruparumomochi	ぱるぱるももち
achan	あちゃん
miyu	みゆ
ichigo	いちご
neki	ねき
netarosu	ネタロス
akagi	あかぎ
managi	マナギ
yui	ゆい
tomokage	ともかげ
teni	てに
an	あん
makomopon	まこもぽん
tomatoeren	トマトエレン
kuriani	くりあに
kurotarou	黒太郎
miya	ミヤ
ototabi	音旅
takumario	たくマリオ
kaede	かえで
sanmakoushiki	さんま公式
mameneko	まめねこ
mame	まめ
koyuki	こゆき
mimimi	みみみ
chikako	ちかこ
seikouudoku	晴耕雨読
tontaro	トンタロ
unichan	うにちゃん
hoshikaze	ほしかぜ
ranmaru	蘭丸
souya	そうや
kinakopan	きなこぱん
wataken	わたけん
mizo	みぞ
koyuki	こゆき
shiori	しおり
maimo	ﾏｲﾓ
akumakun	悪魔君
yamamoto	やまもと
gyuu	ぎゅう
romuko	ろむ子
takirotaki	たきろたき
nekomata	猫又
chiyokoreitou	チヨコレイトウ
choroken	ちょろけん
emyongo	えみょんご
umetama	うめたま
shishikuro	獅子クロ
gomadare	胡麻だれ
kino	キノ
shihona	しほな
haruichi	ハルイチ
neguse	ねぐせ
shiara	しあら
mikokoro	みこころ
saimu	債務
gyoran	ぎょらん
umetoumeto	梅糖めと
majo	魔女
kiyono	きよの
akane	あかね
runameri	るなめり
kayoyon	かよよん
akua	アクあ
ochiyun	おちゆん
yukina	由希奈
momiji	もみじ
koyuki	こゆき
hiragi	ひらぎ
tanukimaru	たぬき丸
yuutan	ゆーたん
koto	こと
shigure	時雨
aki	秋
asashan	あさしゃん
toppazure	トッパズレ
machidamegane	町田メガネ
sanukinokirinji	讃岐の麒麟児
hamon	はもん
shironku	しろんく
takuan	たくあん
jimin	ジミン
poehiko	ぽえ彦
masa	マサ
tanaka	たなか
shizukumaru	しずくまる
menou	めのう
momocho	ももちょ
monisoku	もに速
ruumoche	るぅもちぇ
satomi	さとみ
akemin	あけみん
irohasu	いろはす
satoimo	里芋
popopo	ぽぽぽ
aosakishizuku	蒼咲雫
supadan	すぱだん
tamukei	たむケイ
aroma	アロマ
sasako	ささこ
nanashi	ななし
shinonome	東雲
nomunomu	ノムノム
mugi	ムギ
erumisu	エルミス
naomi	なおみ
chiyama	ちやま
hanta	はん太
nanamaru	ななまる
karuma	カルマ
kuzera	くぜら
tsubamemaru	つばめまる
takara	宝
mikazuki	三日月
sorasakura	空桜
takeru	たける
yuuki	ユウキ
minato	みなと
rui	るい
sakuya	さくや
wakabanana	わかばなな
marina	毬那
anmitsu	あんみつ
akuserina	アクセリナ
yoruko	夜子
yoshirin	よしりん
harucha	春茶
fuwaru	ふわる
tomokikun	ともきくん
piyomaru	ぴよまる
haribono	はりぼの
akira	あきら
poporikun	ぽぽりくん
sentarou	せんたろう
yunoasu	ゆのあす
ekopiko	えこぴこ
bechiko	べちこ
kobuhana	こぶはな
kinako	きなこ
ansa	アンサ
takenoko	たけのこ
ryama	リャマ
hashiani	はしアニ
shinchanman	しんちゃんまん
suzusana	鈴沙菜
beshi	べし
udon	うどん
chizu	ちづ
kana	かな
kinakomochi	きなこもち
kabo	かぼ
mochimashiro	もちましろ
akira	アキラ
yusanako	ゆさなこ
nobu	のぶ
taiya	たいや
piropiro	ピロピロ
kumakurage	くまくらげ
zakuro	ざくろ
poteneko	ぽてねこ
ayaha	あやは
pumosan	ぷもさん
matamaru	またまる
suzukiri	すずきり
rirunya	りるにゃ
bote	ぼて
uepyon	うえぴょん
higu	ひぐ
fuji	藤
tarachan	たらちゃん
ayase	綾瀬
shiki	四季
nayu	なゆ
kiryuu	きりゅー
yuueroaka	ユウエロ垢
matobamui	的場無為
nikumaru	肉丸
hatonoko	ハトノコ
sei	せい
namako	なまこ
sedato	せだと
hotamin	ホタみん
takosupasuta	タコスパスタ
shiori	栞
etekou	エテ公
takara	宝
ama	あま
tamatan	たまたん
aomurasaki	青紫
izumin	いずみん
oga	おが
tanyaka	たにゃか
punichan	ぷにちゃん
hotori	穂酉
mojaoshou	もじゃ和尚
shamaru	シャマル
keron	けろん
supiritasu	すぴりたす
kinuko	絹子
neon	ネオン
uita	ういた
pippi	ぴっぴ
marumi	まるみ
wakataka	若貴
suzuki	すずき
kurouri	くろうり
hazuki	葉月
mokkosu	モッコス
woyumi	ヲユミ
tokosuke	トコスケ
andoriru	あんドリル
puniko	ぷに子
hotohoto	ほとほと
io	いお
yashiki	屋敷
midorime	緑芽
abeshin	あべしん
aochin	あおちん
ohiyo	おひよ
yagoyagogo	やごやごご
fantomuyuu	ファントムゆう
takumi	匠
sasanoha	笹の葉
mochiko	もちこ
hinachan	ヒナちゃん
rin	凛
goushin	ごうしん
noriaki	のりあき
maasan	まぁさん
ringo	りんご
raito	ライト
yuran	ゆらん
kusugaya	くすがや
juna	ジュナ
harumi	ハルミ
kira	キラ
ayako	アヤコ
narippa	なりっぱ
kanden	韓伝
yuua	ゆうあ
harachan	はらちゃん
kousei	コウセイ
sakamotochan	坂本ちゃん
taiyaki	たいやき
marina	麻里奈
sakuro	さくろ
kon	琿
nachi	那智
nabe	ナベ
kurokishi	くろきし
mabo	まぼ
kazu	数
yunemi	ゆねみ
tamo	たも
tobimako	とびまこ
eringi	エリンギ
engawa	えんがわ
kurogura	クログラ
yokisoba	よきそば
miyu	みゆ
ramune	ラムネ
ienari	いえなり
kuro	くろ
ari	あり
serisu	せりす
akimaru	秋丸
hirorin	ひろりん
satorin	さとりん
shun	しゅん
benonomu	べののむ
torizakana	トリざかな
kazuaki	カズアキ
kibu	きぶ
kurouroko	黒鱗
midorin	ミドリン
goetaro	ごえたろ
saboten	サボテン
tomorin	ともりん
nyan	にゃん
hagina	萩奈
yukime	ゆきめ
tanabe	田辺
kamepanda	カメパンダ
chinatsu	千夏
nekomi	ねこみ
runa	るな
takepon	たけぽん
masa	まさ
aonagi	蒼凪
asagao	あさがお
hyou	ヒョウ
yukkuri	ゆっくり
yakiniku	焼肉
mamikichi	まみきち
touya	とうや
rina	りな
ken	ケン
suriza	すりざ
harusame	はるさめ
nekomeshi	猫飯
minito	ミニト
sasakiraimu	佐々木来夢
mamikichi	まみきち
nekomaru	猫まる
nabetarou	鍋太郎
kutsushita	くつした
ryuuya	リュウヤ
hakutou	ハク糖
maiyan	まいやん
mamoron	まもろん
tatsuya	たつや
samo	さも
tanukinoponta	狸のぽんた
umibouzu	うみぼうず
jupi	ジュピ
tsumurin	つむりん
nene	ねね
hakumu	はくむ
beasoku	べあそく
kyouka	きょうか
naruwashi	なるわし
matakazu	またかず
buimama	ぶいまま
kagayaki	輝き
paru	パル
takechiyo	たけちよ
karasu	カラス
paru	パル
shinshin	しんしん
shinshin	しんしん
kagura	かぐら
tanaka	たなか
jupi	ジュピ
kin	きん
yakiedamame	やきえだまめ
ganjigarame	がんじがらめ
hanayuu	はなゆー
kasa	かさ
amamoyowo	あまもよを
wafuyo	わふよ
mana	ﾏﾅ
orin	おりん
kana	かな
owari	終
katamimi	カタミミ
shouta	翔太
saaya	さあや
ishikoro	石ころ
takekushin	ﾀｹｸｼﾝ
naoki	ナオキ
shachikuchan	社畜チャン
rekuan	れくあん
jupi	ジュピ
sanbasou	さんば挿
sakucha	さくちゃ
sakuranbo	さくらんぼ
hinata	ひなた
reisen	レイセン
zenri	善利
puchitabi	プチ旅
yoshio	よしぉ
meganemaru	めがねまる
inagakiyasuto	イナガキヤスト
misoteika	みそていか
remu	れむ
airi	あいり
asato	朝斗
hiro	ひろ
akaimajin	あかいまじん
yamaneko	やまねこ
nishinchan	にしんちゃん
orijin	おりじん
wataame	わたあめ
aegukano	喘ぐカノ
uedaya	うえだ屋
yosaku	与作
rinyoran	りにょらん
koza	こざ
masamune	マサムネ
yuriaaaa	ゆりああああ
mimizuku	ミミズク
maukeru	まうける
sake	さけ
hiroimu	ヒロイム
rena	れな
onryu	おんりゅ
nirugiri	にるぎり
kingyo	金魚
orikage	おりかげ
tomo	とも
kanariko	かなりこ
peraimaru	ぺらい丸
kuroniji	黒虹
gyunto	ギュント
sakura	さくら
sette	セッテ
daichi	だいち
chiba	ちば
yuriia	ゆりいあ
tomoka	ともか
akioji	あきおじ
chihaze	ちはぜ
iguana	イグアナ
mio	みお
sudaashiya	須田葦也
anehime	あねひめ
kometogibabaa	米とぎばばあ
paburi	ぱぶり
koume	小梅
surari	すらり
mokku	モック
yuheri	ゆへり
masamipyon	まさみぴょん
ginro	ぎんろ
anchobizamurai	アンチョビザムライ
esuto	エスト
monmon	もんもん
asami	浅見
shagami	しゃがみ
mokkaseiya	モッカセイヤ
shintanimayumi	新谷真弓
tamu	たむ
kanade	かなで
misumaru	みすまる
osamuchin	おさむちん
hoshinome	ホシノメ
hanamiya	はなみや
shitorera	シトレラ
yura	ユラ
hachi	ハチ
niwaka	ニワカ
fumu	ふむ
muku	椋
nannonanigashi	何の何某
tetsu	てつ
yupi	ゆぴ
moka	もか
kobayan	こばやん
himagine	ヒマギネ
hirudoa	ひるどあ
nikuchan	にくちゃん
yuka	ゆか
koiakane	恋茜
nubuchan	ぬぶちゃん
ankokuou	暗黒王
shouta	翔汰
maroi	まろい
uniru	うにる
nika	ニカ
meronpan	メロンパン
akaringo	あかりんご
irotsuka	いろつか
ringo	りんご
samidare	さみだれ
nakamin	なかみん
takajin	タカジン
fujimoranai	フジモらない
hiyokonbu	ひよこんぶ
origamiyoshika	オリガミヨシカ
nagi	凪
toritan	とりたん
nazuchan	なずちゃん
noki	のき
airentaso	あいれんたそ
muru	むる
shun	しゅん
zerohina	ぜろひな
toki	鴇
numako	ぬまこ
tororo	とろろ
zakuro	ざくろ
akizu	あきず
pepapipu	ぺぱぴぷ
souta	そうた
ui	うゐ
peso	ぺそ
kabochadonchan	カボチャどんちゃん
honotori	ほのとり
maria	マリア
nyasu	にゃす
maopi	まおぴ
moyashimo	もやしも
naofumi	なおふみ
abesawako	安倍佐和子
kiui	きうい
owarishima	終島
sazanami	さざなみ
mikase	みかせ
makira	まきら
rin	りん
marufukusatoshi	丸福さとし
moudamepo	もうだめぽ
mao	ﾏｵ
migozuku	みごずく
homuhomu	ほむほむ
gokuakushimura	極悪志村
noppi	のっぴ
mugicha	麦ちゃ
kiri	桐
minato	ミナト
kuri	くり
arakidonsan	あらきどんさん
fura	ふら
takaya	タカヤ
aonagi	蒼凪
toyosu	とよす
hakuji	白磁
dada	だだ
tensha	天赦
maepyon	まえぴょん
aoichan	葵ちゃん
puuta	ぷうた
harekumo	ハレクモ
mizuiharuka	水井はるか
yaasan	やーさん
natsukusa	夏草
yukawa	湯川
eimi	えいみ
rina	りな
yume	ユメ
shiratama	しらたま
kakiihiro	柿井ヒロ
aru	ある
kurogane	くろがね
tokage	とかげ
tsuyutsuki	つゆつき
omiso	おみそ
pikumin	ぴくみん
satorin	さとりん
mozukaso	もずかそ
omikujimegane	おみくじめがね
sorano	そらの
takuanya	沢庵屋
haisenshori	敗戦処理
hiiro	ひいろ
meigenroku	名言録
tsubasa	つばさ
paipankan	パイパン館
chikure	ちくれ
kaju	かじゅ
miya	宮
ginnashi	銀梨
horikazu	ホリカズ
hirokke	ひろっけ
rioringo	りおりんご
buhikun	ブヒくん
sayuta	さゆた
akagi	赤城
sayo	さよ
soshageimo	ソシャゲイモ
mochimochi	もちもち
daitoi	ダイトイ
toriniku	とりにく
asahi	あさひ
higashinonono	東ののの
meronpan	めろんぱん
ebikatsu	えびかつ
suiseimaou	水星魔王
wo	を
setagaya	せたがや
kikuwa	きくわ
yoshietsuneo	よしえつねお
satoimo	さといも
akane	アカネ
hibiyazerosan	ひびやゼロサン
yamagasuki	山が好き
fuyu	冬
wataame	わたあめ
yumi	ゆみ
gan	がん
oshirasama	おしらさま
hamachi	はまち
goroku	語録
kinako	きなこ
akisuteto	あきすてと
uri	うり
rizume	りずめ
bakiko	ばき子
hibiki	ひびき
hase	はせ
maho	まほ
chikushi	ちくし
naotomo	なおとも
saburin	サブリン
ararin	あらりん
taigyo	たいぎょ
roroi	ろろい
nikachan	ニカちゃん
keita	ケイタ
bakakun	バカくん
suzukaze	涼風
nagomi	なごみ
meme	めめ
seimei	晴明
kuroneko	黒猫
hamako	はまこ
iyo	いよ
sora	そら
bukiko	ぶきこ
kunimotoyuka	國本由佳
funaosu	ふなおす
kakinyako	かきにゃこ
kururun	くるるん
rina	りな
seipakuhasu	セイパクハス
chikafujisan	ちかふじさん
yuusan	ゆうさん
zakuro	柘榴
suguru	スグル
rio	りお
enoki	えのき
ayami	あやみ
tachibon	たちぼん
natsume	ナツメ
razu	らず
akane	あかね
itemae	いてまえ
hatame	傍目
pyonkichi	ぴょんきち
bakakun	バカくん
akinoshin	あきのしん
ruise	るいせ
azusauta	梓歌
yamasan	ヤマさん
yuuya	優也
zebi	ぜび
tomono	友乃
zebi	ぜび
hiroto	ひろと
midorineko	緑猫
kinyami	きにゃみ
jisubon	じすぼん
kuruto	くると
tororo	とろろ
ochamaru	お茶丸
bonta	ぼんた
muraikoutarou	村井幸太郎
kanshirin	かんしりん
shirokuma	シロクマ
karen	カレン
mahirume	真昼目
sekibuntoku	積分解く
nerikeshi	ねりけし
chibesupa	ちべすぱ
kimitaka	キミタカ
okiami	おきあみ
orenokoe	俺の声
waewae	わえわえ
dorekore	どれこれ
moko	モコ
sebonebokiboki	背骨ボキボキ
arare	あられ
ababa	あばば
saradapanda	サラダパンダ
takaiwa	たかいわ
soraran	そららん
yosuga	よすが
makomakohonaka	まこまこ本垢
pausan	ぱうさん
nonnon	のんのん
roki	ロキ
mitsuba	みつば
karin	かりん
seina	せいな
yuzukichi	ユズきち
katchan	カッチャン
amano	あまの
chano	ちゃの
hananagahime	はなながひめ
magumagumaguron	まぐまぐまぐろん
miya	宮
shuwawan	しゅわわん
sagyougi	作業着
maru	まる
arupaka	アルパカ
mana	まな
gontakun	ゴンタ君
pu	ぷ
iori	いおり
mikimaro	みきまろ
kuropo	くろぽ
konyu	こにゅ
hiroki	ひろき
yoki	よき
eiji	映児
hizako	ひざこ
purukuu	プルクゥ
naruko	なるこ
nekota	猫田
aoaki	青秋
akasa	あかさ
konishitama	小西たま
wakonosuke	わこのすけ
gumyu	ぐみゅ
roroi	ろろい
nyokki	にょっき
sawaki	沢木
mikutoshi	みくとし
girigiri	ぎりぎり
souki	ソウキ
momoko	ももこ
takosu	タコス
reona	れおな
mossama	もっさま
toravisu	トラヴィス
suika	すいか
nyanmomo	にゃんもも
yamadananami	山田ナナミ
tekkimon	テッキモン
kasabuta	かさぶた
kazuma	かずま
tapibarasan	タピバラさん
hanakuma	はなくま
pirokaku	ぴろかく
terorin	テロリン
nami	なみ
marichan	まりちゃん
aruto	あると
yumiyumi	ユミユミ
nomopi	のもぴ
toipopo	トイポポ
fuki	フキ
tsuromuyoshi	ツロムヨシ
kokoko	こここ
mayushie	まゆしえ
okaka	おかか
enuya	えぬや
mumu	むむ
madoimeguru	まどいめぐる
furitsuna	フリツナ
kikori	木こり
kojio	こじお
negita	祢宜田
kana	かな
rechoko	れちょこ
hamaya	破魔矢
aotongo	蒼斗ンゴ
rinta	りんた
tanmaru	たんまる
micha	みちゃ
nekomodoki	猫もどき
ahiru	家鴨
keita	ケイタ
aabakadana	ああバカだな
sonodarisa	そのだりさ
kokoro	こころ
kanakana	かなかな
ru	る
karouaruaru	過労あるある
manotake	まのたけ
mokawa	もかわ
akaneko	アカネコ
zura	ヅラ
inemurimajin	居眠り魔神
koitsu	こいつ
otooto	音音
umineko	うみねこ
saba	さば
nasubi	なすび
kapihami	カピハミ
okakita	岡北
haroran	はろらん
karaitarako	カライタラコ
nakakoko	中ここ
shinobu	しのぶ
hana	はな
chihiro	ちひろ
hachi	はち
bokkionsen	勃起温泉
tetsuo	てつお
tanchi	たんち
kohana	こはな
same	さめ
ami	亜魅
mokepon	もけぽん
bunharu	ぶんはる
kotoki	ことき
bokuriho	僕りほ
yarin	やりん
uhyou	うひょう
kuroi	クロイ
ayori	あより
takapanda	たかぱんだ
chiimama	ちーまま
kenkuri	けんくり
banira	ばにら
yasogami	ヤソガミ
tokiwa	ときわ
hi	ひ
tateko	たてこ
kanamomo	かなもも
konotsuki	このつき
tanaka	たなか
higu	ひぐ
nannannanon	なんなんなのん
hatame	傍目
kouneko	こうねこ
riu	りう
rizume	りずめ
atsuto	あつと
yozora	ヨゾラ
inonogisan	イノノギさん
chiimama	ちーまま
nana	なな
tetsuo	てつお
rokuji	ろくじ
toravisu	トラヴィス
yoko	よこ
kokonasuikechan	ココナス池ちゃん
muteki	無敵
soriburu	そりブル
nonotan	ののたん
sobana	そばな
sakuya	朔弥
aokei	あおけい
tarao	たらお
dare	誰
ponsuke	ぽんすけ
imokenpii	芋けんぴぃ
chitonyan	ちとにゃん
himakiba	ひまきば
amadare	あまだれ
natsuka	なつか
ayuwo	あゆを
umetama	うめたま
kairi	カイリ
shimizumikukasu	清水みくかす
gomadare	ごまだれ
nyashimashi	にゃしまし
rena	レナ
kuranpukurou	クランプクロウ
gutara	ぐたら
tagameago	タガメ顎
eriko	えりこ
kii	きぃ
meiji	めいじ
soratobi	そらとび
chibita	ちび汰
yaoshin	やおしん
shami	しゃみ
misogikun	みそぎくん
namahage	なまはげ
tennenkoji	天然居士
kubikorihidoi	首こりひどい
misogikun	みそぎくん
monpuchi	もんぷち
aisunokami	アイスの神
chokobo	チョコボ
minatsuki	水無月
meukau	メウカウ
nakanohito	中野ひと
hamachii	はまちー
kaokaoko	かおかおこ
yancharu	やんちゃる
tsukamura	ツカムラ
yaeba	やえば
kobutagazou	子豚画像
yukidango	雪団子
shiina	しいな
shuka	シュカ
miya	ミヤ
fumi	ふみ
mobu	モブ
oda	織田
nekodekiai	ねこ溺愛
rauto	らうと
migiri	砌
yamiyohaakaku	闇夜は赤く
kasumi	香純
yanan	ヤナン
hararaita	ハラライタ
koroeda	ころえだ
yoshimitsu	よしみつ
dorasura	ドラスラ
mutenka	無添加
matcha	まっちゃ
nekohina	猫ひな
sebire	せびれ
kotora	ことら
risounoimouto	理想の妹
onsoku	おんそく
rencha	れんちゃ
akito	あきと
kagaribi	篝火
sabo	さぼ
adorisu	アドリス
nono	のの
kyorochan	キョロちゃん
komorin	こもりん
takibi	タキビ
yukimi	ゆきみ
akiton	あきとん
hikarigon	ひかりごん
zenigame	ぜにがめ
uotsumi	うおつみ
take	たけ
tarou	たろう
ouji	王子
ohagi	御萩
sumikiran	すみきらん
moeka	もえか
tabero	食べろ
seimeinori	生命の理
shira	シラ
aochin	あおちん
kawauso	ｶﾜｳｿ
minakuma	ミナくま
kurokami	くろかみ
aro	あろ
fuwafuwanokuma	ふわふわのくま
nikoru	ニコル
raba	らば
aruko	あるこ
emu	えむ
yuzupon	ゆずぽん
gomaeri	ごまえり
waiyowai	ゎぃょゎぃ
hachikou	はちこう
iyohebi	伊予へび
saki	さき
kocha	こちゃ
mojimojira	もじもじら
kujira	鯨
momiji	もみぢ
ibaruchan	いばるちゃん
masayuki	まさゆき
hayarun	はやるん
makinoji	まきのじ
zono	ぞの
hayarun	はやるん
yamagen	やまげん
piero	ピエロ
denpaminami	電波南
shinshi	紳士
amiya	あみや
reicheru	レイチェル
kaho	かほ
kana	かな
akarino	あかりの
teruyo	てるよ
inpara	インパラ
sanyu	サンユ
kojikin	こじ金
kuroe	くろえ
takawossan	たかをっさん
pepirikku	ペピリック
hinami	ヒナミ
misachasu	みさちゃす
himawari	向日葵
reideru	れいでる
nemui	眠い
runa	るな
ayasaki	あやさき
zeromaki	ゼロマキ
ikarashi	いからし
saiki	サイキ
shirayuki	白雪
maru	まる
arimamiko	ありまみこ
naokame	なおかめ
takapanda	たかぱんだ
konsu	こんす
otamaro	おたまろ
kuroe	くろえ
namahage	なまはげ
mayuge	まゆげ
chibiruri	ちびルリ
kamishiro	神代
mitako	みたこ
vakaunto	ヴァかうんと
umiko	うみこ
inanae	いななえ
tsuchinoko	つちのこ
minatoya	湊屋
torakichi	とらきち
enbashira	えんばしら
ishitsubute	イシツブテ
poporin	ぽぽりん
hetaresunohara	ヘタレ春原
naruo	なるお
yukineko	ゆきねこ
yutaantena	ゆたアンテナ
chirosubaru	チロすばる
mikazuki	ミカヅキ
tadano	ただの
amanezumi	あまねずみ
katsuya	かつや
roku	ろく
fukuchi	ふくち
ourin	おうりん
mitoteya	みとてゃ
rinma	りんま
satoshi	サトシ
semishigure	蝉時雨
hanayanagishiho	花柳志保
maho	まほ
nanotan	なのたん
hanayanagishiho	花柳志保
oniko	おに子
ikumin	いくみん
akuesu	あくえす
konsuke	こんすけ
kou	こう
buntan	ぶんたん
yaminoma	やみのま
achamo	アチャモ
tatsurotto	タツロット
mumi	無味
aki	あき
megane	メガネ
yura	由良
arumi	あるみ
nonoko	ﾉﾉｺ
arisa	ありさ
fuyune	冬祢
hirata	平田
gyogyogyo	ギョギョギョ
samore	さもれ
watarininja	ワタリニンジャ
uten	うてん
kanawo	カナヲ
hachimaru	はちまる
goniataito	ゴニアタイト
meka	めか
nekotamasudare	猫玉スダレ
rei	伶
aoi	アオイ
iwatobichan	いわとびちゃん
haru	ハル
nezumi	ねずみ
pikatarou	ピカ太郎
ibajiji	イバジジ
nakamu	なかむ
ishiaki	石アキ
seikaitan	政界たん
uyutaso	うゆたそ
kurekotoba	くれことば
taue	田植え
ichigo	いちご
momomiya	ももみや
kyon	きょん
yussan	ゆっさん
kamyu	かみゅ
yamaniku	やまにく
hatsuga	はつが
kirikawa	霧川
maki	まき
minchu	みんちゅ
massu	まっす
matsu	まつ
aira	あいら
okitsunesama	おきつねさま
hajiko	はじこ
maicho	まいちょ
poyoyonmaru	ぽよよんまる
mame	まめ
perorun	ぺろるん
neko	ねこ
esoto	えそと
takara	たから
kazu	かず
ino	ヰノ
suzuki	すずき
botamochi	ボタモチ
rion	リオン
yukiho	ゆきほ
nijiirohotaru	虹色ほたる
kopene	こぺね
aruhime	アル姫
npa	ンパ
asutoro	アストロ
zaku	ざく
sakamoto	坂本
kameji	かめじ
zerosuke	ゼロすけ
kisasan	きささん
zono	ぞの
pisuke	ぴすけ
hayato	隼人
teranokane	寺の鐘
watabou	わたぼぅ
kuroshio	くろしお
oyoyo	オヨヨ
minato	みなと
kain	かいん
pokosuke	ぽこすけ
hotaruika	ホタルイカ
hizashi	ヒザシ
bakyura	ばきゅら
bote	ぼて
maetoo	まえとー
marota	まろた
yasapen	やさぺん
hikaru	ひかる
sakura	さくら
waizu	ワイズ
megitarou	めぎ太郎
keibadegenkin	競馬で現金
enhi	えんひ
agario	アガリオ
marumaru	まるまる
nana	なな
nyanta	にゃんた
ria	りあ
fujimotosetsuna	藤本セツナ
chisaki	ちさき
oshamanbe	長万部
kei	けい
ievan	イエヴァン
nisoku	にそく
nitamago	煮玉子
ejirin	えじりん
happa	はっぱ
yukke	ゆっけ
tayu	たゆ
rimo	リモ
shikison	しきそん
hokusetsu	ほくせつ
dano	ダノ
sakuraba	さくらば
mori	森
reorivaru	レオリヴァル
matsunoki	まつのき
noka	のか
rabirabi	らびらび
wakya	わきゃ
ayaka	あやか
maya	まや
kaninin	かににん
konami	こなみ
fussan	ふっさん
zukimi	ずきみ
kiku	菊
miyaran	みやらん
shinja	信者
ririkku	りりっく
muta	ムタ
tsuan	つぁん
yuuna	ユーナ
rara	らら
kiria	キリア
kokkaichan	国会ちゃん
akiko	明子
raimi	らいみ
kouseki	功績
imo	いも
ichiko	いちこ
kemokoma	けもこま
taka	たか
jintarou	じんたろう
yuki	ユキ
yui	ゆい
yoyo	よよ
miyuki	美雪
yakan	矢間
penpen	ぺんぺん
hotamin	ホタみん
sekainotakenoko	世界のたけのこ
ame	あめ
daijin	大臣
boruwo	ボルヲ
kiyo	きよ
mamamametarou	まままめたろう
kingyoneko	金魚猫
yukiru	ゆきる
manitto	まにっと
wakaba	ワカバ
hidarippana	ひだりっぱな
keron	けろん
aoba	あおば
yabime	やびめ
budou	ぶどう
mamamametarou	まままめたろう
yoichomaru	よいちょ丸
shizuku	シズク
maya	まや
hirosura	ひろスラ
tenshi	てんし
munouyarou	無能野郎
kabosu	かぼす
puimuutan	ぷいむーたん
hayabusa	はやぶさ
uru	うる
ameame	雨飴
hiyorin	ひよりん
nekopan	ねこパン
hiroshi	ヒロシ
togemori	とげもり
yossan	よっさん
kamukamu	カムカム
asako	麻子
yukichi	ゆ吉
miari	みあり
riputon	りぷとん
eda	えだ
tetsugaku	哲学
ankake	あんかけ
myuu	みゅう
gorori	ゴロリ
kazamaraita	風間雷太
masu	ます
koorihikari	氷光
hakumaru	箔丸
rei	れい
momoyuu	ももゆう
hirata	平田
neochi	寝落ち
shino	しの
fumino	ふみの
naenaee	なえなええ
dokusen	独占
mu	む
ion	イオン
soa	そあ
sakuratouri	桜とうり
miyazakion	宮崎温
kumatta	くまった
zakosakura	ざこさくら
higubeni	ひぐべに
natsunoko	なつのこ
moe	もえ
fujimanta	ふじまんた
sunsuke	すんすけ
miyaran	みやらん
watari	わたり
norakuro	のらくろ
gurida	ぐりだ
kinta	きんた
asayu	あさゆ
toumei	とうめい
agedori	あげどり
nagome	なごめ
momonga	ももんが
joutouhei	上等兵
araneko	あらねこ
bangou	番号
yurikoanone	ユリコあのね
takenama	たけなま
uga	うが
bako	バコ
akanashi	あかなし
dokuonigiri	どくおにぎり
inomari	いのまり
tsuna	つな
azuki	あずき
takimaru	瀧丸
nabemichi	なべみち
yukkin	ゆっきん
aburimura	あぶりむら
hanamaru	はなまる
kuroneko	黒猫
kametomo	かめとも
kurage	くらげ
shiguto	しぐと
shia	しあ
reito	れいと
yama	やま
nemu	ねむ
tomoe	ともゑ
karakurisan	からくりさん
chiha	ちは
mezaki	メザキ
moririndaimaou	モリリン大魔王
kokusuibaka	国粋馬鹿
kamenoko	かめのこ
kintani	キンタニ
masa	まさ
arasuru	アラスル
mizuno	水の
pakeura	パケ裏
esse	エッセ
netarou	ねたろう
tsukiyomizuku	ツキヨミズク
peru	ぺる
mitsuto	みつと
ukana	うかな
jaimaru	ジャイ丸
akaisuisei	赤い彗星
feiren	ふぇいれん
koperu	こぺる
daifukumaru	大福丸
sumikan	すみかん
ruripon	るりぽん
nisa	ニサ
ruri	瑠璃
mariomonogatari	マリオ物語
gumyu	ぐみゅ
chiro	ちろ
itachi	イタチ
maru	まる
nikumamushi	肉蝮
merimeri	めりめり
udon	うどん
nikaji	にかじ
byakuya	白夜
tomatoman	とまとまん
yuu	侑
mumei	ムメイ
shinkainoawa	深海の泡
ranmaru	蘭丸
touya	トウヤ
essa	えっさ
surume	鯣
katsudon	かつどん
shiomiya	潮宮
maimi	まいみ
kerako	けらこ
pamyu	ぱみゅ
ruse	ルセ
suruga	するが
kuyumushi	くゆむし
shu	しゅ
yuyuyu	ゆゆゆ
bunakanoki	ブナ科の木
hinami	飛波
ucha	うちゃ
ginchan	銀ちゃん
suguri	すぐり
zaki	ザキ
nikumamushi	肉蝮
souta	ソウタ
kaede	かえで
megane	めがね
yamiyohaakaku	闇夜は赤く
ookami	オオカミ
chiyo	ちよ
fuchi	ふち
koshinuni	こしぬに
ruru	るる
amagin	アマギン
ka	蚊
nze	んぜ
yurayuri	ゆらゆり
namaharumaki	生はるまき
ragi	ラギ
hama	はま
takasan	たかさん
kinugoshi	絹ごし
appou	あっぽう
inoharu	イノハル
keyaki	欅
purupuru	ぷるぷる
maruipan	まるいパン
yoko	よこ
mokuzu	もくず
momousa	ももうさ
yukiyanagi	雪柳
ironnagaa	いろんながー
irohasu	いろはす
hiyoriaika	日和藍茄
namitoibu	なみといぶ
hotsuo	ほつお
kenji	ケンヂ
jungaga	じゅんがが
oonabe	大鍋
yuna	ゆな
nodoka	長閑
yukiya	ゆきや
kenji	ケンヂ
arakidonsan	あらきどんさん
yametekudasai	やめてください
nyanta	にゃんた
musao	むさお
borurin	ぼるりん
noaka	ノアカ
yuttan	ゆったん
atsumu	あつむ
kuroma	くろま
kento	ケント
harutoma	ハルトマ
maguo	まぐお
himechan	ひめちゃん
suisen	スイセン
hirappi	ひらっぴ
kanata	彼方
namaneko	なまねこ
osakana	おさかな
kurono	くろの
muutan	むーたん
ike	イケ
rokuha	ロクハ
kisaragirei	如月零
bou	坊
kasasagi	かささぎ
hakaishin	破壊神
karen	かれん
mozaikun	モザイ君
sendai	せんだい
owanchan	おわんちゃん
monmon	もんもん
oohagari	おおはがり
bou	坊
tapikaro	タピカロ
monu	もぬ
meranipo	めらにぽ
ashura	アシュラ
hiro	ひろ
chikokuma	ちこくま
nanochan	なのちゃん
rumu	ルム
mottsuan	もっつぁん
kanamiya	かなみや
fuminari	ふみなり
suzuki	すずき
mikehitsuji	みけひつじ
sunsuke	すんすけ
yozakura	よざくら
harusame	はるさめ
sakaagari	さかあがり
seiran	晴嵐
borurin	ぼるりん
charadion	チャラディオン
tanaka	たなか
ooga	オーガ
fugugu	ふぐぐ
anchandamono	あんちゃんだもの
ooji	大路
hiko	ひこ
kenpi	けんぴ
atsumaru	あつまる
sasomin	さそみん
pandazuki	ぱんだずき
kurubushinenza	くるぶし捻挫
mie	ミエ
yuu	悠
mokuzu	もくず
aochin	あおちん
aochin	あおちん
mame	まめ
oohirume	おおひるめ
taki	たき
ayumu	あゆむ
oyatsuhime	おやつ姫
yaegan	やえがん
takumi	タクミ
poppo	ぽっぽ
yagiyasuo	ヤギヤスオ
amayukiesuka	あまゆきえすか
amayukiesuka	あまゆきえすか
tsuromuyoshi	ツロムヨシ
mireisasara	みれいささら
yomisen	読み専
sotan	そたん
howako	ほわこ
sasanyan	ささにゃん
kihara	气原
amaiankonomama	あまいあんこのママ
niwoku	にをく
tomo	トモ
hogepiyo	ほげぴよ
mouken	もうけん
nao	ナオ
raimugi	らいむぎ
rikomaru	りこまる
nou	のう
mikoshiba	みこしば
konsuke	こんすけ
nandeyanen	なんでやねん
kamanemata	かまねまた
taki	た木
samidare	さみだれ
rikuya	陸矢
modo	もど
kanchobi	かんちょび
erumisu	エルミス
rui	類
sabo	さぼ
rion	リオン
torikura	とりくら
mosuke	もすけ
houkifuji	伯耆富士
aoshirobo	あおしロボ
noa	ノア
dadapunte	だだぷんて
kon	紺
koishi	こいし
morisato	もりさと
modo	もど
rein	れいん
atsupiyo	あつぴよ
pirohiro	ぴろひろ
keito	けいと
tobari	鳥羽莉
atsupiyo	あつぴよ
nen	ねん
indojin	いんどじん
tottsuan	とっつぁん
a	ｱ
edenchan	えでんちゃん
raimu	ライム
rikuru	りくる
mochiya	餅屋
puttsun	ぷっつん
manjuu	まんじゅう
ragi	ラギ
kagemaru	影丸
mirea	みれあ
tachi	たち
okamo	おかも
kiiroiyane	黄色い屋根
kuu	クウ
noraneko	野良猫
misaki	みさき
yui	ゆい
tokuchan	とくちゃん
amiri	あみり
zerokasu	ゼロカス
paisen	ぱいせん
yuurin	ゆうりん
keiji	ケイジ
umeo	うめお
hatto	はっと
akimiko	あきみこ
meta	メタ
umatan	うまたん
yoasobi	よあそび
pantohachi	パンとはち
ayano	あやの
hiyoshiterari	ひよしてらり
misaki	みさき
aisa	あいさ
toeshin	トエシン
ginnosuke	ぎんのすけ
mitsuka	みつか
parumu	ぱるむ
monchi	もんち
chiiharu	ちいはる
mezoforute	メゾフォルテ
yatara	やたら
habaneruna	はばねるな
youkaiondo	ようかいおんど
popoa	ぽぽあ
baru	ばる
akkarin	あっかりん
haraki	はらき
sakoto	さこと
yonabari	ヨナバリ
amiigo	あみぃゴ
jaian	ジャイアン
rabyu	らびゅ
aoto	蒼斗
kuina	くいな
ikutayoshikatsu	生田よしかつ
fuyu	ふゆ
anko	あんこ
hiro	ひろ
yakoko	ヤココ
pino	ピノ
shangurira	しゃんぐりら
aoi	あおい
gon	ごん
nanna	なんな
umika	うみか
chia	ちあ
aeka	あえか
matsukichi	まつきち
take	たけ
koha	こは
egahetako	エガヘタコ
matsuko	まつこ
sasashi	笹史
yuru	ゆる
zatsuko	ざつこ
karen	かれん
dona	ドナ
makkachan	まっかちゃん
kai	かい
moka	モカ
yomogi	よもぎ
myaako	みゃあこ
watabee	わたべぇ
makicha	まき茶
hitsujisada	ひつじさだ
noaka	ノアカ
chino	ちの
soba	そば
takuan	たくあん
hanna	ハンナ
hirokamu	ひろかむ
toarukun	とあるくん
mao	まお
yaya	ヤヤ
rerameido	レラメイド
i	伊
toramike	とらみけ
kabeko	壁子
rei	零
sora	そら
ponkichi	ぽんきち
natsumikan	なつみかん
yumeru	夢瑠
hosono	ホソノ
souta	創太
taka	タカ
mon	もん
konohana	このはな
hanna	ハンナ
eromanga	えろまんが
ruka	るか
oyun	おゆん
atsuki	あつき
saki	さき
tamama	たまま
yoshinyan	よしにゃん
tachibana	たちばな
gaya	がや
hanna	ハンナ
aiko	愛子
akiakane	秋茜
imokenpii	芋けんぴぃ
nakatomiasuka	中富あすか
okki	おっき
guraburuyou	グラブル用
ojiro	おじろ
iori	いおり
hashitto	はしっと
izumi	いずみ
nebukuro	ネブクロ
meipuru	めいぷる
kuroro	くろろ
mezoforute	メゾフォルテ
kana	かな
rario	らりお
shigesan	しげさん
ta	た
toi	とい
kira	きら
tomomi	ともみ
reiko	麗子
kotorinosei	ことりのせい
mezoforute	メゾフォルテ
ikama	いかま
sakutomo	さくとも
ahiruchan	あひるちゃん
haruhito	はるひと
aju	あじゅ
kishiri	キシリ
kanototori	辛酉
mono	もの
hikaru	ひかる
kotobuki	ことぶき
hiroimu	ヒロイム
chiyarin	ちやりん
manekichi	マネキチ
tekuteku	てくてく
mochu	もちゅ
ame	あめ
rasuyan	ラスやん
tajirin	たじりん
tsuruchan	つるちゃん
eiyafiyatora	エイヤフィヤトラ
vorira	ゔぉりら
nodame	のだめ
mizuno	水野
kazumi	かずみ
enrikun	えんりくん
okino	沖野
nanako	ななこ
yumemako	ゆめまこ
atsumin	あつみん
takayuki	たかゆき
yukko	ゆっこ
hinomoto	火ノ元
nonchi	のんち
shirakawa	白川
shizuku	しずく
pannakotteri	ぱんなこってり
danu	だぬ
neotsuchi	ねおつち
koshiryuka	こしりゅか
sakura	桜
zan	ざん
monakasenpai	モナカ先輩
hinako	ひなこ
chokora	ちょこら
pipitori	ぴぴとり
nanna	なんな
kazu	カズ
yukiusagi	雪うさぎ
sawayakamikan	さわやかみかん
pochasen	ぽちゃ専
namahamu	なまはむ
takuya	たくや
kuresuko	くれすこ
makaron	まかろん
oyaben	おやべん
yuka	ゆか
oriiyaki	オリー焼き
manchin	まんちん
towori	とをり
miaki	みあき
chiisanpokopon	ちいさんぽこぽん
shiihenakiru	しいへなきる
razu	らず
umi	海
marumori	まるもり
yakuruto	やくると
kazuchan	かずちゃん
anzu	あんず
myomyo	みょみょ
kaimu	カイム
hayate	疾風
mumei	無名
kinkan	きんかん
seika	せいか
doraneko	ドラねこ
inagakiyasuto	イナガキヤスト
hikari	ひかり
ishikoro	石ころ
masahiro	まさひろ
poipoi	ぽいぽい
hikomaru	ひこまる
rakka	ラッカ
pachiko	ぱちこ
amin	あみん
rikopin	りこぴん
yotsubakun	よつばくん
kazuchan	かずちゃん
kiri	桐
miyaji	みやじ
aoto	あおと
gasuya	ガス屋
hayabusa	はやぶさ
riato	リアト
yupe	ゆぺ
hetarehomurasan	へたれほむらさん
kurosana	クロサナ
ezo	えぞ
pipi	ピピ
nekojita	ねこじた
revu	レヴ
hauto	はうと
hiyo	ひよ
rariporari	らりぽらり
nobuhiro	信宏
maruhage	まるはげ
kozueko	梢子
yukki	ゆっき
gomashoku	ごま食
yumemi	ユメミ
chia	ちあ
naoko	なおこ
maboroshinotomo	まぼろしのとも
shia	しあ
ebi	えび
akkun	あっくん
moriinaba	もりいなば
reo	れお
yamamoyashi	やまもやし
kurouri	くろうり
rui	ルイ
ochan	おちゃん
arima	ありま
norikaku	のりかく
usapi	うさぴ
mesuton	めすとん
hakohama	函浜
rubedo	ルベド
runba	ルンバ
tsugumi	ツグミ
bunorin	ぶのりん
usamemasanobu	卯鮫正信
yurika	ゆりか
ichigochoko	苺ちょこ
miyu	みゆ
pyon	ぴょん
saka	さか
himi	ひみ
naa	なあ
nemuchi	ねむち
chaso	ちゃそ
ginnosuke	ぎんのすけ
mugi	麦
anemo	あねも
chiibuu	ちいぶー
hinase	ヒナセ
raki	らき
mugicha	麦茶
numa	ぬま
maru	まる
temuyu	てむゆ
ohanachan	おはなちゃん
nippori	日暮里
omeme	おめめ
shimatofu	シマトフ
taison	タイソン
kawarashima	河原嶋
rokuyongo	ロクヨンゴ
mori	もり
otoha	オトハ
maromaro	まろまろ
rinka	りんか
goetaro	ごえたろ
noraosamu	野良修
bobinzuru	ぼびんずる
tamurasaketen	田村酒店
tokizami	ときざみ
maman	ママン
osatsu	おさつ
seina	せいな
amatsuhitsuki	あまつひつき
shiroju	しろじゅ
miuka	みうか
marukamato	まるかまと
subaru	昴
kazupon	かずぽん
otosuke	オトスケ
saku	炸
matako	またこ
so	そ
youkouro	溶鉱炉
kaname	ｶﾅﾒ
penta	ぺんた
tarou	太郎
kaitoma	かいとま
riruna	りるな
hitotose	ひととせ
yurion	ユリオン
gantetsu	がんてつ
yodomori	よどもり
ouji	王子
satoteshisuto	ｻﾄﾃｼｽﾄ
tomosan	ともさん
takuo	たくお
vaara	ヴァーラ
kaitoma	かいとま
haikaraichiban	ハイカラ一番
tomosan	ともさん
kazemakase	風まかせ
yukke	ユッケ
higasa	ひがさ
hina	ひな
nattougopan	納豆ごぱん
donkachi	ドンカチ
yawaragi	やわらぎ
rin	りん
moguninnin	もぐにんにん
aowain	青ワイン
mimitan	みみたん
yukitai	ゆきたい
pako	パコ
okunawa	おくなわ
omaruchan	おまるちゃん
rei	れい
ogawan	おがわん
nomikke	のみっけ
riko	りこ
torisuki	鳥好き
michi	みち
azuazuki	あずあずき
touyama	とうやま
woruma	をるま
renya	れにゃ
kana	かな
kokui	こくい
mikarinoshi	みかりノシ
chiyu	ちゆ
dego	デゴ
mon	もん
neruru	ねるる
ginko	ギンコ
akoratta	アコラッタ
mirai	みらい
ahiruchan	あひるちゃん
watabou	わたぼう
kudopero	くどぺろ
niseojiro	ニセオジロ
sumi	すみ
gorugo	ゴルゴ
maikun	マイ君
hinoki	ひのき
semi	せみ
mikku	みっく
sawatei	さわてぃ
onose	おのせ
yumemikyabetsu	夢見キャベツ
pankirin	パンキリン
kuu	くぅ
sayuki	紗雪
asunaro	アスナロ
yasushi	やすし
masayan	まさやん
yamiri	やみり
yujimiya	ユジミヤ
kozue	こずえ
arisa	ありさ
yotto	よっと
toshiaki	としぁき
asagiri	朝霧
potapenko	ぽたぺんこ
dora	どら
kisoriron	基礎理論
watarininja	ワタリニンジャ
zunmochikoa	ずんもちこあ
buchi	ブチ
suika	すいか
hare	はれ
sakuragi	桜木
fumipon	ふみぽん
shirasu	しらす
ramuchan	ラムちゃん
soara	そあら
asajiri	アサジリ
marumiyakun	まるみやくん
haruse	春瀬
riona	りおな
sangon	さんごん
kisaragirin	如月凛
kusugaya	くすがや
kuu	クウ
yuu	ゆう
harami	ハラミ
yunyu	ゆんゆ
chinatsu	ちなつ
yazora	やぞら
yatara	やたら
haroharo	はろはろ
tsukika	つきか
roka	ろか
misaki	みさき
umeko	梅子
suzunariya	鈴鳴り屋
shinorua	しのるあ
sumikawa	墨川
ekotora	エコトラ
bansai	バンサイ
utame	うため
roni	ロニ
hashiguchi	橋口
rarikkusu	ラリックス
gon	ごん
kameokago	亀岡語
aisu	アイス
yumiko	ゆみこ
marikichi	まりきち
nobou	のぼう
hirotaka	ひろたか
rozurozu	ろずろず
yamadaya	山田屋
takamura	たかむら
katsuragi	桂木
miarekaina	ミアレカイナ
arimakinen	有馬記念
ibuki	伊吹
zean	ゼアン
yamadaya	山田屋
tsuba	つば
riruremon	りるれもん
ichi	いち
zako	ざこ
rozurozu	ろずろず
irina	いりな
sakana	サカナ
hiiro	緋色
yutamaru	ゆたまる
hikari	ヒカリ
ayuna	あゆな
yamosabo	やもさぼ
sosorori	ソソロリ
furikake	ふりかけ
koke	こけ
saten	サテン
akito	あきと
gitao	ぎたお
vianka	ヴィアンカ
yuji	ゆじ
tabayoshiki	たばよしき
rikoru	リコル
orisei	オリセイ
karuron	かるろん
takemaru	たけまる
sankiyo	さんきよ
ichan	いちゃん
mion	みぉん
kurohebi	黒蛇
yumeban	ゆめばん
nonbiri	のんびり
minamikoora	南コーラ
senri	せんり
miyakotto	みやこっと
naoruhi	なおるひ
honnenopapa	本音のパパ
ichino	いちの
mizuki	みずき
meguri	めぐり
uniguri	うにぐり
nainai	ないない
cheru	ちぇる
yuzuriko	ゆずりこ
hiiro	ひいろ
iyuka	いゆか
beru	べる
koyata	こやた
panpukin	ぱんぷきん
zurizurin	ずりずりん
gyouninben	ぎょうにんべん
tsushima	津島
himekapo	ひめかぽ
bora	ぼら
oto	おと
azamin	アザミン
uyamuya	うやむや
irukujira	イルクジラ
manohochi	間野ホチ
chi	ち
zumo	ズモ
ameda	あめだ
beshimajinari	べしまじなり
karuto	カルト
uranami	うらなみ
nekojita	ネコジタ
yokatako	よかタコ
hayonero	はよねろ
hiyori	日和
anemone	アネモネ
isemagu	いせマグ
shirokuma	しろくま
radauta	ラダウタ
chizuru	千鶴
nako	なこ
taketon	たけとん
kokoro	こころ
kenkuri	けんくり
neotaru	ねおたる
omami	おまみ
mogunoshin	モグノシン
enuenu	えぬえぬ
kuropo	くろぽ
gyouzachan	餃子ちゃん
nekoarashi	ねこあらし
daikun	だいくん
muuru	むーる
usapu	うさぷ
kanakichi	かな吉
uhiku	うひく
mamoyarotao	まもやろたお
kako	かこ
minto	みんと
papipu	ぱぴぷ
kamaboko	かまぼこ
ueeee	うええええ
ringoame	りんご飴
furanorana	ふらのらな
mikan	みかん
kyon	きょん
koguwa	こぐわ
mirai	みらい
yuukichi	ゆうきち
aihara	相原
mikkun	みっくん
kanon	かのん
midori	みどり
kopakoa	コパコア
genji	げんじ
mumu	むむ
motoko	もとこ
suzukiyasuyuki	鈴木泰之
tomowaka	ともわか
kiui	キウイ
tajima	田島
mittsu	みっつ
kamewai	かめワイ
ika	いか
togi	トギ
techitaro	てちたろ
pukkun	ぷっくん
warabimo	わらびも
edonko	えどんこ
onichanneru	鬼チャンネル
hagi	はぎ
roi	ロイ
narupajin	ナルパジン
shika	しか
ippo	いっぽ
inaina	いないな
poppotan	ポッポタン
sakasama	さかさま
kasasama	カサさま
chiko	ちこ
tomi	とみ
shimishimi	しみしみ
yuragi	ゆらぎ
mirai	みらい
hitorigoto	ひとりごと
suzuhi	スズヒ
kinsan	きんサン
innaka	いんなか
zeno	ゼノ
kana	かな
toki	とき
ayato	綾斗
onasu	おなす
tokei	時計
tsurara	つらら
soyo	そよ
ahiruchan	あひるちゃん
nanaonao	ななおなお
yuusaku	ゆうさく
kya	きゃ
komasan	コマさん
takepon	たけぽん
inagakiyasuto	イナガキヤスト
kichida	きちだ
ri	り
npi	んぴ
saritote	さりとて
soramame	そらまめ
rezamari	レザマリ
fukuha	ふくは
sawayanagi	サワヤナギ
rinuraaka	りん裏垢
shikounofuukei	至高の風景
satomin	さとみん
gami	がみ
kirua	きるあ
petan	ぺたん
neritake	ねりタケ
koge	こげ
taka	たか
roro	ろろ
yukichoko	雪チョコ
arusuta	あるすた
akikan	あきかん
aki	あき
shinata	しなた
roeru	ロエル
sayurin	さゆりん
tekunomo	てくのも
nagare	ながれ
saro	さろ
unikurage	うにくらげ
nonno	のんの
pokumonu	ポクモヌ
muchiko	むちこ
yoshitomo	よしとも
torami	とらみ
taihei	たいへい
korosuke	ころすけ
mimarea	ﾐﾏﾚｱ
kuromitsu	黒蜜
tonton	とんとん
kiriu	きりう
nari	なり
oume	おうめ
yuriia	ゆりいあ
hanamaru	はなまる
yuka	ゆか
otamaru	おたまる
neron	ねろん
kiyosuke	きよすけ
matsuda	松田
yuusuke	ゆーすけ
udonko	うどんこ
tesshi	てっし
dozaimonta	どざいもんた
hoshinabe	ほしなべ
makotemu	まこてむ
mei	メイ
okapi	おかぴ
kuuta	くぅ太
wanta	碗太
haseramuda	ハセラムダ
ekure	エクレ
metappou	メタッポウ
matsu	マツ
nanna	なんな
midori	みどり
toshi	とし
kinokuchi	キノクチ
yuunyan	ゆうにゃん
azuma	アズマ
meto	めと
koumei	こうめい
kinakomochi	きなこ餅
mimei	ミメイ
hokumaru	ほくまる
gen	げん
mikyan	みきゃん
yodasemaru	よだせまる
tanin	他人
muchiko	むちこ
iroha	いろは
miru	ミル
tabuneko	たぶねこ
madarame	まだらめ
hanashiawanai	はなしあわない
keanabijin	毛穴美人
nemui	眠い
shino	シノ
yasutomo	ヤストモ
arimainochi	有馬命
tomatoma	とまとま
neon	ねおん
yakepachi	ヤケパチ
zerotsuki	ぜろつき
yamauni	やまうに
senya	せにゃ
tsukumo	つくも
amaguri	あまぐり
riku	陸
semihito	せみひと
minamo	ﾐﾅﾓ
matcha	まっちゃ
hinagiku	ひなぎく
sasakama	ささかま
popon	ぽぽん
manekineko	まねきねこ
tsumugi	つむぎ
meacha	めあちゃ
aya	あや
asu	あす
mokoimo	もこいも
mojame	もじゃめ
nakae	中江
mogami	もがみ
kino	キノ
sugiyan	すぎやん
ruri	瑠璃
shirako	しらこ
bisuketan	ビスケたん
muninichi	むににち
maiko	まいこ
asuka	飛鳥
shirogoto	しろごと
oishiiiiniku	おいしいいいにく
koishiro	恋しろ
yuse	湯瀬
ochomo	おちょも
hatori	はとり
rumika	るみか
dokupe	ドクぺ
sake	さけ
shiatoro	しあとろ
yusa	ゆさ
kinyami	きにゃみ
usagi	うさぎ
mashumaroinu	マシュマロ犬
mainu	まいぬ
chaso	ちゃそ
yokoshima	よこしま
matsuge	まつげ
komai	こまい
shunsuke	シュンスケ
araiguma	あらいぐま
suzu	すず
sasurai	さすらい
asano	浅野
saezuki	さえづき
horigotatsu	ほりごたつ
kokudougou	国道号
bebisura	ベビスラ
okamekorokoro	オカメコロコロ
minase	みなせ
rikka	立夏
roro	ろろ
amane	あまね
kusomushimika	くそむしみか
nikumaru	ニク丸
kumamotoaichi	熊本愛知
shika	鹿
kussuu	クッスー
moritani	もりたに
ienire	家楡
hoku	ほく
shima	しま
moromi	醪
nekonoizumi	猫の泉
kinkan	きんかん
oniku	お肉
akemon	あけもん
bunpuku	ぶんぷく
katsukara	かつから
tachi	たち
ninose	二ノ瀬
momoan	ももアン
yuuka	ゆうか
reina	れいな
futodoki	ふとどき
shun	しゅん
yokota	よこた
kanata	かなた
chacha	ちゃちゃ
karasuma	烏マ
rurutaro	るるたろ
yaku	やく
kurutoga	くるとが
harukana	はるかな
jatako	じゃた子
inukun	いぬくん
boroboton	ボロボトン
naro	なろ
yaabon	やぁぼん
seto	せと
oguragawa	おぐらがわ
bassa	ばっさ
hoichi	ほいち
yamashin	やましん
koimo	こいも
pengin	ぺんぎん
mikan	みかん
namako	なまこ
mashiro	ましろ
akitakeda	あきたけだ
buu	ブウ
kounyan	こうにゃん
hidebu	ひでぶ
saeki	佐伯
otomeko	おとめ子
hinata	ひなた
hayane	早寝
rintaku	りんたく
buripan	ブリパン
reira	レイラ
doze	どぜ
aoi	あおい
zerokasu	ゼロカス
garigarikun	ガリガリ君
matsumoto	まつもと
kui	杭
ryouki	涼季
arue	あるえ
zarabu	ざらぶ
izumi	いずみ
noi	のい
suraimu	スライム
yakuoyoso	約およそ
mi	み
takuteitoku	たく提督
tetsuki	テツキ
chibibi	ちびび
warumo	わるも
meguun	めぐーん
aiai	あいあい
mimionigiri	みみおにぎり
nari	なり
nakamura	中村
nayuta	なゆた
tapitanyan	たぴたにゃん
mikeke	みけけ
kiichi	きーち
shachi	シャチ
narumi	なるみ
uri	瓜
komakimako	こまきまこ
tsukasa	つかさ
ababa	あばば
ronronron	ろんろんろん
wanzouko	わんぞうこ
mitsukajimaya	ミツカジマヤ
mia	みあ
kerutarosu	ケルたろす
rena	れな
wata	わた
urisan	うりさん
kuro	くろ
noripan	のりパン
koba	こば
no	の
miyutama	みゆたま
kanaedesu	佳苗です
shinomiya	篠ミヤ
okutan	おくたん
suzumebachi	すずめばち
otohachi	音はち
honmushi	本虫
shino	しの
kana	かな
aoto	あおと
ooiminami	大井みなみ
kyutte	きゅって
konta	こんた
nanoha	なのは
yopiko	よぴこ
hirokazu	ひろかず
dentetsu	でんてつ
enyou	エンヨウ
shakku	しゃっく
chibi	ちび
tetsugaku	哲学
mio	ミオ
takashi	たかし
reira	レイラ
taiju	たいじゅ
nonon	ののん
kouon	こうおん
nekomakura	猫枕
tamago	たまご
nubuchan	ぬぶちゃん
rarato	ららと
toriri	とりり
kenjadora	賢者ドラ
miyu	みゆ
funaosu	ふなおす
jin	陣
kamuro	かむろ
koppen	こっぺん
chachamaru	茶々丸
sunsun	すんすん
tamu	たむ
uruhaa	うるはぁ
shinohara	しのはら
futtora	ふっとら
matsuge	まつげ
yuno	ユノ
mikeneko	三毛猫
ninuki	にぬき
airi	あいり
yukikaze	ゆきかぜ
jaga	じゃが
tateo	たてお
e	ゑ
mihosakura	みほ桜
yuuu	ゆうう
esunai	えすなゐ
shokora	ショコラ
kino	紀乃
asagi	あさぎ
yume	夢
narumin	なるみん
nemuinezumi	ねむいねずみ
hoshiume	干し梅
osamuchin	おさむちん
meronpan	メロンパン
chiroru	チロル
amamizu	雨水
sumidagawa	隅田川
yurinenko	ゆりねんこ
arurira	あるりら
nini	にに
kamiwokun	かみをくん
bukiyoutouchan	不器用父ちゃん
yuri	ゆり
bariguachi	ばりぐあち
ahiruchan	あひるちゃん
omochi	おもち
kobayansu	こばやんす
kazune	かずね
kokatorisu	コカトリス
kirara	きらら
yasu	ヤス
nyanko	にゃんこ
inagakiyasuto	イナガキヤスト
makira	まきら
takamiku	たかみく
nini	にに
hamutan	ハムたん
honkawa	ほんかわ
ruto	ると
gominoesa	ゴミの餌
satorenko	サトレンコ
ren	憐
yukishiki	ゆきしき
atobejunjun	跡部じゅんじゅん
asari	あさり
marumedia	まるめでぃあ
kuroki	くろき
kaname	かなめ
kotori	コトリ
taruten	タルテン
odoro	オドロ
pasuta	パスタ
nagase	ながせ
non	のん
buruha	ブルハ
ramochi	らもち
hagakikatteren	ハガキ勝手連
tesona	テソナ
ringo	林檎
kamo	かも
nemuinezumi	ねむいねずみ
toma	とま
temarineko	手毬猫
hima	ひま
mizuha	みずは
yuki	雪
sayonaka	さよなか
gurakongu	グラコング
guraburu	ぐらぶる
haruna	はるな
hikosan	ヒコさん
mitsuru	みつる
tomozu	ともず
anzu	あんず
shibainukichi	しばいぬきち
han	はん
matatabu	またたぶ
kamome	かもめ
mona	もな
noshimochi	のしもち
kumami	くまみ
hamada	浜田
asatsuki	あさつき
eite	エイテ
reinadon	れいなどん
jako	じゃこ
mochi	もち
matsuge	まつげ
hikosan	ヒコさん
kachimushi	勝ち虫
nagomu	なごむ
nanoka	なのか
migozuku	みごずく
uraaka	裏垢
kanako	加奈子
reigi	玲儀
desune	ですね
nanamushi	ななむし
yuka	ゆか
motoso	もとそ
tsuyoshi	つよし
toriri	とりり
migozuku	みごずく
migozuku	みごずく
nono	ノノ
ikatake	いかたけ
kurokka	クロッカ
anehime	あねひめ
yamaman	やままん
seisai	正妻
uzura	うずら
owaten	オワテン
nagisa	渚
toriinu	とりいぬ
acha	あチャ
akita	あきた
chihaze	ちはぜ
yurariro	ゆらりろ
kotoko	古都子
kimikun	キミくん
haivu	ハイヴ
machio	まちお
shouta	翔汰
funkorogashi	ふんころがし
reni	れに
tama	たま
sorano	そらの
saotaya	さおたや
kira	きら
aonori	青ノリ
hima	ひま
sayaka	さやか
tarotaro	たろたろ
nuime	ぬいめ
hachikiku	ハチキク
nana	なな
kaku	かく
yoitomake	ヨイトマケ
baobabu	バオバブ
marimon	毬藻ン
dokayama	ドカ山
suzukuma	鈴熊
saki	さき
byaon	びゃおん
suratan	すらたん
shion	シオン
kanata	かなた
ron	ロン
mamimaminomami	まみまみのまみ
inugami	いぬがみ
hagayui	はがゆい
wasabimaru	わさびまる
kotobuki	ことぶき
hime	姫
reikun	玲君
toshi	トシ
kuroinu	黒犬
soraha	そらは
hepichan	へぴちゃん
arikino	アリキノ
hiro	ひろ
takana	たかな
tsuruko	ツルコ
ikaruga	いかるが
gachirin	がちりん
yuuyu	ゆうゆ
gaku	がく
honemi	ほねみ
kokatorisu	コカトリス
atamaru	あたまる
riri	りり
noeru	のえる
kaori	かおり
itsuki	いつき
komemaru	こめまる
sora	ソラ
aotaku	あおたく
umi	うみ
purun	ぷるん
abumi	あぶみ
otsuko	おつこ
guyun	ぐゆん
potaki	ぽたき
eichan	えいちゃん
nozumi	のずみ
kurone	クロネ
tsukinowaguma	ツキノワグマ
kamisama	神様
honda	ホンダ
higashi	ヒガシ
okkun	オックン
shirota	白た
nyanmaru	にゃんまる
isaki	いさき
komari	コマリ
umi	うみ
yatanatarou	やたなたろう
chi	ち
komemaru	こめまる
kuronomittan	黒のみったん
fujino	藤野
erika	えリか
ako	あこ
aiai	あいあい
hashidori	はしどり
suama	すぁま
ayapo	あやぽ
tomo	とも
haruyan	はるやん
nekossu	ねこっす
moedesu	もえです
sayopon	さよぽん
nurupe	ぬるぺ
sayumyun	さゆみゅん
aoyami	蒼闇
peke	ぺけ
amio	あみお
omoimabuta	おもいまぶた
komemaru	こめまる
atagoeri	愛宕えり
inuri	いぬり
oshitosan	お使徒さん
doragun	どらぐん
pirohiko	ピロ彦
shifaro	しふぁろ
bin	ビン
tora	とら
miradori	みらどり
natsukaze	夏風邪
pochi	ポチ
kanitama	かにタマ
hikomaru	ひこまる
cheshuchi	ちぇしゅち
kashima	鹿島
yume	ゆめ
yuki	有紀
nyankoroge	にゃんころげ
hiraran	ひららん
fuu	ふう
mamadon	ままどん
baru	ばる
hirawo	ひらを
mizuna	みずな
maguro	マグロ
kirin	きりん
jitaken	じたけん
kanimiso	かにみそ
chikuwaroketto	ちくわろけっと
yukiruma	ゆきるま
kobito	こびと
mekajiki	めかじき
rara	らら
chibesuna	チベスナ
kuruha	くるは
nero	ネロ
kantoku	監督
morishima	もりしま
sadayuki	さだゆき
aokuma	青熊
inuchan	いぬちゃん
heitaro	ヘイタロ
panzu	ぱんず
komichi	こみち
nerucharo	ネルちゃろ
otsuki	おつき
yukishi	ゆきし
nyaki	ニャキ
mokomoko	もこもこ
ponte	ぽんて
ataru	あたる
nantatsu	なんたつ
kobato	こばと
nayun	なゆん
nikomikisan	にこみきさん
teikoku	帝国
monaka	もなか
chonchon	ちょんちょん
shikaekemu	しかえけむ
nanahan	ななはん
mozuku	もずく
takohabaka	タコは馬鹿
tanikun	谷くん
kishiri	キシリ
mahiru	まひる
sanhachi	さんはち
yufushiro	ゆふしろ
niano	にあの
sakurai	さくらい
renasu	レナス
roppongitengoku	六本木天国
demigura	でみぐら
koruri	こるり
kusunokianzu	楠木杏
rokuroku	ロクロク
yamadee	やまでー
maachan	まぁちゃん
inakichi	イナキチ
aoyagi	青ヤギ
momideko	もみでこ
rimu	りむ
suzuko	すずこ
aimi	あいみ
kurunasu	くるなす
madoreenu	まどれーぬ
nyao	にゃお
asaneko	麻猫
kerotan	ケロたん
urichisa	うりちさ
rasentaitei	螺旋大帝
moko	もこ
natsume	なつめ
kirimiya	きりみや
namahage	ナマハゲ
hangorinnokai	反五輪の会
izuki	いずき
hanetani	はねたに
mikinao	みきなお
zokusei	属性
amanatsu	甘夏
torakichi	虎吉
shin	しん
kimidori	キミドリ
yuyurin	ゆゆりん
todomako	とどまこ
kunka	くんか
zakuro	柘榴
hiroki	ひろき
burita	ぶり太
man	まん
kanchan	かんちゃん
imajinneo	イマジンネオ
sanotsuki	さのつき
nike	にけ
takamatsu	高松
sakinko	さきんこ
kaiminhou	快眠法
koba	コバ
yusa	ゆさ
ribere	りべれ
asaneko	麻猫
ochabu	おちゃぶ
karintou	かりん糖
osamu	おさむ
kanorin	かのりん
gen	ゲン
hisa	ひさ
shinchan	しんちゃん
furuken	ふるけん
sai	サイ
moa	もあ
amashoku	あましょく
funiko	ふにこ
bakatsu	ばかつ
kusabi	楔
nakagawa	なかがわ
namuta	なむた
manmaru	まんまる
daifuku	大福
yukinko	ゆきんこ
okami	おかみ
tenpu	てんぷ
tomo	とも
reia	れいあ
ikura	いくら
dokenzenchan	ド健全ちゃん
yugi	ゆぎ
takumama	たくまま
roba	ロバ
hinachan	ひなちゃん
ohagitokinako	おはぎときなこ
rara	らら
tomonosuke	とものすけ
rurupi	るるぴ
akari	あかり
imajinneo	イマジンネオ
horin	ほりん
natsume	夏目
shikazumi	しかずみ
mikiyona	みキよナ
viru	ゔぃる
maron	マロン
yura	ユラ
soushi	そうし
chitosesana	千歳佐奈
mikurumama	みくるママ
rokuroku	ロクロク
yamana	やまな
aki	あき
maggyo	マッギョ
napi	なぴ
mochita	もちた
motoko	もとこ
ui	ぅぃ
mirin	みりん
fuguri	ふぐり
toyohon	とよほん
odachamame	おだちゃ豆
mikihiko	ミキヒコ
yuu	ユウ
rei	レイ
shiro	シロ
pukupoko	ぷくぽこ
gorogoro	ごろごろ
tomonobu	とものぶ
shirakumosan	しらくもさん
oburuta	オブルタ
dosei	どせぃ
sui	翠
mitsuba	みつば
chonchon	ちょんちょん
hana	ハナ
nasome	ナソメ
heita	へいた
hiroto	ひろと
ino	いの
aoneko	青猫
momose	百瀬
eichi	えいち
isagiyoku	いさぎよく
obake	おばけ
sasshi	冊子
kusunoki	くすのき
rinarina	りなりな
sukai	スカイ
yuzu	ゆず
kohaku	琥珀
anzu	あんず
kaorin	かおりん
fujio	ふじお
eri	えり
metarika	めたりか
napi	なぴ
ikuta	いくた
fengari	ふぇんがり
pirukuru	ぴるくる
yuu	ユウ
gagen	臥源
murafumi	むらふみ
yuimei	ゆいめい
medamanome	めだまのめ
kozeni	こぜに
kikkoro	きっころ
mikarin	みかりん
fukuramikake	ふくらみかけ
rin	りん
manakame	まな亀
riruna	りるな
miri	みり
yacha	やちゃ
ayu	あゆ
fuurin	ふうりん
miyachan	みやちゃん
chikano	ちかの
haru	はる
marimo	マリモ
ai	あい
unimi	うにみ
kagerou	かげろう
shigeharumu	しげはるむ
zakishin	ざきしん
mimi	みみ
nipisuke	にぴすけ
yatarou	弥太郎
yumikko	ゆみっこ
tsukunenenenene	つくねねねねね
ryun	りゅん
kamiyan	かみやん
mashino	ましの
ko	こ
funima	ふにま
makun	まくん
hemoko	へもこ
kakao	かかお
achimaru	あちまる
muge	むげ
kanewo	カネヲ
hannarimako	はんなりまこ
yumikko	ゆみっこ
yakita	やきた
onigiri	おにぎり
sanmama	サンママ
chigenabe	チゲ鍋
tatan	タタン
biwamotchi	びわもっち
eihi	えいひ
koharu	こ春
yumikko	ゆみっこ
aki	あき
tatsutaage	たつたあげ
namatako	生たこ
amemiya	雨宮
torehan	とれはん
kubokei	くぼけい
cha	茶
hinamatsuriko	雛まつり子
nusasabi	ぬささび
himawari	ひまわり
kuruko	くる子
chirokun	チロくん
shiaha	シアハ
shiopan	しおぱん
hiromi	ひろみ
emiko	えみこ
haineko	灰猫
anzu	あんず
koppepan	コッペパン
hariratesu	ハリラテス
fuyuusagi	冬兎
katamura	かたむら
tamago	たまご
kokuri	こくり
machiboni	まちぼに
midoneko	みどねこ
datto	脱兎
saga	さが
gurichiron	ぐりちろん
inu	いぬ
tatsuki	タツキ
aokei	あおけい
yuri	ゆり
yukizaiku	ゆきざいく
sanapen	サナペン
shibatarie	柴田理恵
pirafu	ピラフ
donguri	どんぐり
hiroshi	ヒロシ
yukinoshibari	ユキノシバリ
arufa	アルファ
yukiya	ゆきや
repurikahonmaru	レプリカ本丸
hijiri	ひじり
gou	ゴウ
aria	ありあ
hana	はな
achimaru	あちまる
tomoka	ともか
emera	エメラ
kaisennori	海鮮海苔
harumin	はるみん
daisuke	だいすけ
himagine	ヒマギネ
kentomo	けんとも
nyoro	にょろ
shinokou	しのこう
mikoyo	みこよ
satoken	さとけん
kasane	かさね
rakkyoumiso	らっきょう味噌
hijiringo	ひじりんご
rikuya	陸矢
keryo	けりょ
kuronomittan	黒のみったん
muuumin	むううみん
aomi	あおみ
yukimiku	雪ミク
yomopapa	よもパパ
oretoyakyuu	俺と野球
yumikko	ゆみっこ
nikado	にかど
mayumi	真由美
genki	げんき
nemuinu	ねむいぬ
tenmagin	天魔銀
ramusuke	ラムすけ
hanamai	華舞
sakura	さくら
mikonosu	ミコノス
rimokon	リモコン
kagerou	カゲロウ
sayori	さより
umifukuzakka	海福雑貨
goro	ゴロ
nanaatsu	ななあつ
gingareon	ギンガレオン
yanchan	やんちゃん
torakichi	虎吉
nayokawa	なよかわ
mikari	みかり
kagomechan	かごめちゃん
yukimaro	ゆきまろ
yae	ヤエ
tama	たま
akinii	あきにい
raito	ライト
sakata	さかた
saya	沙弥
hya	ひゃ
yuumi	ゆぅみ
koyuki	こゆき
ameame	あめあめ
tonoko	とのこ
moare	もあれ
piyoko	ぴよこ
noriri	のりり
nazope	なぞぺ
miyu	みゆ
tendon	てんどん
suyuhasu	すゆはす
rokuro	ろくろ
kurutaku	くるたく
eitoku	ゑゐとく
yatanatarou	やたなたろう
kaho	かほ
emi	えみ
ikachan	いかちゃん
maru	まる
kurosukanpi	黒スカンピ
hii	ひぃ
shinzaki	しんざき
suzuki	すずき
hisui	ひすい
shiitake	しぃたけ
moegi	もえぎ
konchi	こんち
yano	やの
tokonero	とこねろ
komesawa	こめさわ
shishimaru	ししまる
ikaniya	いかにや
dorufurousagi	ドルフロうさぎ
keronta	けろんた
nekotakusan	ネコタクサン
chii	ちぃ
poshikemaru	ぽしけまる
namako	なまこ
ranran	らんらん
yota	よた
rikuto	りくと
shishimaru	ししまる
yuzuta	柚田
inuchabin	犬ちゃびん
marugao	まるがお
rito	りと
mirausajihou	ミラウサ時報
hanekoi	跳ね鯉
utena	ウテナ
hagichan	ハギチャン
kuma	くま
koko	ここ
soyokaze	そよかぜ
hina	ひな
nevin	ネヴィン
onyoki	おにょき
ruashi	るあし
suiren	睡蓮
takako	たかこ
mina	みな
shiopan	しおぱん
koguma	子ぐま
tachi	たち
gachirin	がちりん
bayarun	バヤルん
kanoko	かのこ
yotaki	よたき
yano	やの
amadare	あまだれ
shu	しゅ
narushi	なるし
natsumikan	なつみかん
masaakikaku	まさあきかく
yuuki	有希
henchinsai	変珍齋
tenten	てんてん
masashi	まさ氏
sachi	さち
konitan	コニタン
azumine	あずみね
mio	みお
nun	ぬん
kamomesanta	かもめサンタ
shinokumo	しのくも
hihihi	ひひひ
akitora	あきとら
manekichi	マネキチ
fengari	ふぇんがり
matchan	まっちゃん
shinosame	しのさめ
rina	里奈
kurenaiasahi	紅旭
yurina	ゆりな
minoriouen	みのり応援
kai	カイ
aoto	蒼斗
umeta	梅太
surume	スルメ
tomohishi	ともひし
haru	はる
ankake	あんかけ
matsuko	松子
kiru	きる
shirayuki	白雪
rinbuu	リンブー
momose	百瀬
maripan	まりぱん
izaya	いざや
fujio	ふじお
misaki	みさき
tomotomosan	ともともさん
hanahana	はなはな
hirobon	ひろボン
mika	みか
negima	ネギマ
rekami	れかみ
matsujan	まつじゃん
bemu	ベム
ruripon	るりぽん
michirushi	みちるし
ameko	あめ子
hoozukiyama	ほおずき山
nupopoi	ヌポポイ
menruidaisuki	麺類大好き
takuto	拓斗
aine	あいね
majimajiojisan	まじまじおじさん
mutsumi	むつみ
kerokero	けろけろ
riina	りいな
chimaki	ちまき
ri	り
masai	まさい
okimono	おきもの
nagaharu	ながはる
seruiru	せるいる
shibiraki	シビラキ
sakana	魚
hinano	雛乃
hisame	氷雨
rakuten	楽天
mio	澪
hikari	光
hinano	雛乃
ayumukkun	あゆむっくん
kuroko	クロコ
ogyaiku	オギャイク
zarusoba	ざる蕎麦
nafe	なふぇ
marina	まりな
nemo	ねも
mizuirosurasan	みずいろすらさん
maikeru	まいける
yatchi	やっち
taiga	タイガ
usapi	うさぴ
katsuman	かつまん
mami	マミ
komatsuna	こまつな
shibakou	シバコウ
runrun	るんるん
omeme	おめめ
mami	マミ
urihina	うりひな
setsuna	セツナ
hekiruri	碧瑠璃
shimaneko	島猫
rena	れな
shizuku	しずく
umeboshi	うめぼし
hanato	はなと
komatsuna	こまつな
hiromu	ひろむ
onigirikun	おにぎりくん
kokuu	こくう
yakiniku	焼肉
kei	けい
dateyoshimune	伊達よしむね
remontaruto	レモンタルト
nii	にー
icha	イチャ
popopo	ぽぽぽ
riepon	りえぽん
shinonome	東雲
zeara	ぜあら
tomoka	トモカ
rei	麗
esukoressa	エスコレッサ
oyu	お湯
mikan	みかん
himeraruda	ヒメラルダ
kaho	かほ
miho	みほ
ronapure	ろなプレ
suzu	すず
charumera	ちゃるめら
aito	あいと
pento	ぺんと
nishiharu	ニシハル
eriashi	えりあし
chihato	ちはと
goriton	ゴリトン
nobuno	のぶの
yoshiatsu	ヨシアツ
shuuto	しゅーと
kamineko	かみねこ
kanan	カナン
nagamaru	ながまる
nashichi	なしち
tomato	とまと
houkifuji	伯耆富士
sakana	魚
natsuki	ﾅﾂｷ
yakiniku	焼肉
resseiidenshi	劣性遺伝子
buppabupa	ぶっぱぶぱ
nenenyanparari	ねねにゃんぱらり
kutsushita	くつした
ke	け
suzuki	すずき
tsubuo	つぶお
chii	ちー
izuna	イズナ
makume	まくめ
sayapi	さやぴ
rion	りおん
hiruma	ひるま
tokinae	時苗
taroshi	たろし
uutan	うーたん
ren	れん
komahimeko	こまひめこ
taishuuhakase	体臭博士
sagaminohaniwa	相模のハニワ
amane	あまね
kisaragimiiki	如月ミイキ
hitotose	ひととせ
kuroyuki	黒ゆき
terumito	てるみと
nishiki	西木
makutamoto	幕田元
omaru	おまる
saginomiya	さぎのみや
haimi	はいみ
momomaru	ももまる
nanapon	ななぽん
jiyuuya	自由屋
shizuku	雫
inoue	いのうえ
yoshiki	よしき
popura	ぽぷら
rion	りおん
kamokuma	カモクマ
ruka	るか
mofuriasu	モフリアス
emirio	えみりお
mugiwara	麦わら
asakurareiya	麻倉玲也
shima	しま
nekotsukai	ねこつかい
muukaikuu	ムーカイクー
kiikun	キーくん
mashiro	ましろ
satou	砂糖
komai	駒井
miyakekazuki	三宅一樹
eruruu	エルルゥ
ookega	大怪我
nonoemon	ののえもん
bere	ベレ
namakubi	生首
mayu	まゆ
zennano	ぜんなの
roka	ろか
merankorikun	メランコリくん
komaruta	こまるた
kimuchi	きむち
minemoto	みねもと
hazuki	葉月
abaimo	あばいも
tako	たこ
kuroikotatsu	くろいコタツ
ayaha	あやは
takenoko	タケノコ
nattsun	なっツン
eku	えく
sukaten	スカテン
yukkuri	ゆっくり
miyaneyafan	ミヤネ屋ファン
makiri	マキリ
rui	るい
suzuki	すずき
bokuragaita	僕等がいた
nerupi	ねるぴ
kuro	くろ
rakuirin	ラクイリン
kazu	かず
kage	かげ
nipu	ニプ
yuu	ゆう
suzuki	すずき
rudodon	るどどん
piero	ピエロ
onimarunorizou	鬼丸のりぞう
ronfan	ロンファン
hana	ハナ
jinruihaeru	人類生える
satori	さとり
rui	類
nekomatasan	ねこまたさん
arika	ありか
sasurai	さすらい
hinamama	ひなママ
ebimayo	エビマヨ
denjikigaku	電磁気学
suzumebachi	スズメバチ
maguri	まぐり
yayuta	やゆた
ta	た
sawahato	サワハト
nomuchi	のむち
sayuyun	さゆゆん
rikakochama	りかこちゃま
zuya	ずや
ponyamada	ポン山田
mayu	まゆ
damutoro	ダムトロ
hana	花
yukiyuna	ゆきゆな
akinosora	秋野ソラ
utaufumendai	歌う譜面台
toyoshin	とょしん
tarutaru	たるたる
powatto	ポワット
tsutsuji	つつじ
tamamo	たまも
ameyuru	あめゆる
kanya	かにゃ
naeka	なえか
kureyon	クレヨン
kawase	カワセ
fugashi	ふがし
rakkyoumiso	らっきょう味噌
fujiwara	藤原
sunooden	須野おでん
nufufu	ぬふふ
mameshiba	まめ柴
maniwakoumori	真庭蝙蝠
daichan	だいちゃん
howachan	ホワﾁｬﾝ
purakaru	ぷらかる
togemachi	とげまち
oka	おか
nekokuma	ねこくま
rui	るい
marimokkori	まりもっこり
ninjin	にんじん
shiozaia	シオザイア
hebihenge	へびへんげ
shigure	しぐれ
kimuchi	きむち
maru	まる
manchin	まんちん
nanifamu	なにふぁむ
makihara	まきはら
koaramaru	コアラ丸
urumetchi	ウルメッチ
penyota	ぺにょた
terii	てりー
ani	あに
mayu	まゆ
shiori	しおり
kawauso	ｶﾜｳｿ
morotade	もろたで
mimamiman	みまみまん
shiisaa	しーさー
ikuusako	いくうさこ
rato	ラト
yakimikan	やきみかん
tanabe	田辺
saebi	さえび
momonga	ももんが
fudeneko	ふでねこ
hijiri	ヒジリ
tanapoke	たなポケ
kakerun	かけるん
kotorin	ことりん
shikibu	式部
onikure	おにくれ
chiizu	ちーず
mikazuki	三日月
mashimahiroko	ましまヒロこ
rekiko	歴子
moru	もる
nukoneko	ぬこねこ
kimuchi	きむち
umeneriasu	梅ねりアス
morimu	もりむ
shimaken	しまけん
gachapinchan	がちゃぴんちゃん
miso	味噌
nanoka	なのか
safi	さふぃ
yuu	ゆう
haru	はる
minto	ミント
yaminoma	やみのま
riyoru	りよる
shion	しおん
imuncho	いむんちょ
adekasu	あでかす
kuroyuri	黒百合
mitsu	みつ
tabuchi	たぶち
natsumin	なつみん
yaminoma	やみのま
akane	アカネ
horobe	滅べ
bakyou	ばきょう
ohanashimai	おはな姉妹
yuusan	ゆうさん
kubozun	くぼずん
kai	貝
rarea	られあ
toraya	寅弥
tamago	たまご
negiko	ねぎこ
kuropon	クロポン
yuzuki	ゆづき
abiko	あびこ
miyuki	美由紀
fukutarou	ふくたろう
konitan	コニタン
chibio	ちびお
hika	ひか
umeringo	梅林檎
toramaru	とらまる
pioka	ぴおか
nemurinekomaru	眠りねこ丸
mugicha	麦ちゃ
nemurinekomaru	眠りねこ丸
saorin	さおリン
kobun	子分
shigi	しぎ
tapimo	たぴも
yuri	ゆり
piroriyuki	ピロリ雪
amaou	あまおう
maikun	マイ君
kazekun	かぜくん
yakiimo	やきいも
asakawarin	朝河凛
satomi	さとみ
pokopen	ぽこぺん
harumai	はるまい
yukimi	雪見
unegiu	うねぎぅ
anmashi	餡マシ
itamimimi	伊丹みみ
ritsu	リツ
mauro	マウロ
kobomasa	コボマサ
aro	あろ
masarun	まさるん
purin	ぷりん
mame	ﾏﾒ
ohiya	おひや
asasennin	麻仙人
marion	まりおん
takumaru	たくまる
non	のん
haruchi	ハルチ
mirion	ミリオン
miffu	みっふ
mikutoshi	みくとし
cheshuchi	ちぇしゅち
saeki	さえき
hechima	ヘチマ
chibikuma	ちびクマ
mamasu	まます
riia	リイア
seira	セイラ
mea	メア
riki	リキ
sakamotomakoto	サカモトマコト
itazou	いたぞう
kururun	くるるん
umi	うみ
ashiro	あしろ
tamayurakana	タマユラカナ
rio	リオ
rao	らお
hikari	ひかり
kabeko	壁子
sasa	ささ
tsushi	ツシ
kanau	かなう
miyaran	みやらん
yuutan	ゆうたん
harunohana	はるのはな
hinageshi	ひなげし
setsu	せつ
babu	バブ
hotate	ほたて
hayato	ハヤト
riohachi	りおはち
mamuru	まむる
tamago	たまご
umiushi	ウミウ氏
nyanyami	にゃにゃみ
pocha	ぽちゃ
kurimonaka	くりもなか
marimo	まりも
pirooka	ぴろおか
tsuyopon	つよぽん
risa	リサ
sassou	颯爽
atamaru	あたまる
wataame	わたあめ
suzuse	鈴瀬
otoyan	おとやん
enomotoruku	榎本るく
mokepon	もけぽん
darakou	だらこう
yuki	ゆき
mochigome	もちごめ
miootorihiki	みおお取引
tarako	たらこ
yakuruto	やくると
hotate	ほたて
jikasei	自家製
norimaki	のりまき
riechin	りえちん
yokochan	よこちゃん
kenken	ケンケン
ikesho	いけしょ
hiro	ひろ
miffu	みっふ
hotatetarou	ほたてたろう
shizu	しず
shirokuro	シロクロ
itatsu	いたつ
fenia	ふぇにあ
poko	ぽこ
misae	ミサエ
shinomiya	篠ミヤ
ukigoromo	うきゴロも
shobon	しょぼん
osugi	おすぎ
suima	すいま
matsuri	まつり
hironohiro	ヒロノヒロ
keteron	けてろん
harumi	はるみ
hechimaneko	へちまねこ
moko	もこ
omochi	おもち
hirone	ひろね
akemon	あけもん
neriwasa	ねりわさ
araiwa	あらいわ
kaba	かば
azuma	あずま
megu	めぐ
egaononinja	笑顔のニンジャ
nahamukun	なハムくん
aoba	青葉
haruka	はるか
hiro	ひろ
riri	りり
kitapaso	きたぱそ
takamo	たかも
fenia	ふぇにあ
teto	テト
peporon	ペポロン
nekomikan	ねこみかん
haru	はる
hachi	ハチ
dokanmania	ドカンマニア
kinkin	キンキン
sanamaru	さなまる
nichiya	にちや
yumiso	ゆみそ
nazousagi	謎兎
iria	いりあ
asuka	あすか
haruno	はるの
unagimentai	うなぎめんたい
koyayan	こややん
yadon	やどん
azuki	あずき
potte	ぽって
hiromi	裕美
sakamaki	さかまき
akari	アカリ
amameru	あまめる
marukai	まるかい
kohaku	こはく
ruto	ると
ruma	ルマ
isamu	いさむ
yozakuraayami	夜桜あやみ
kurasafuka	クラサフカ
runo	るの
yukimaru	ゆきまる
rabitora	らびとら
gekikara	激辛
yuusan	ゆうさん
kannagi	観凪
pokatomosan	ポカ友さん
kyanon	きゃのん
kon	紺
riyo	りよ
takuri	たくり
akemon	あけもん
moka	もか
hana	はな
yaniwani	やにわに
tomako	とまこ
tonakai	トナカイ
asama	あさま
miroku	弥勒
nyon	にょん
takahashi	高橋
yamabuki	ヤマブキ
okotaneko	おこた猫
rokumai	ろくまい
furahisa	フラヒサ
yukikaze	ゆきかぜ
ichijou	いちじょう
kanata	かなた
wakoudo	若人
maatan	まぁたん
usa	うさ
momomomoka	ももももか
mikenekomatagi	三毛猫またぎ
oto	おと
hiru	ひる
yumenomaru	ゆめのまる
toriipipiki	鳥居ぴぴき
shigure	シグレ
furahisa	フラヒサ
rani	ラニ
kuroe	クロエ
nna	んな
benio	紅緒
yofukashishimai	夜更かし姉妹
rura	ルラ
takirousan	たきろうさん
tsuchio	ツチオ
sai	サイ
neguse	ねぐせ
pero	ペロ
masakiyami	マサキヤミ
shishamo	ししゃも
fukushimaginji	ふくしまぎんじ
kiri	キリ
nosuke	のすけ
bangisu	バンギス
omochi	おもち
higahayato	比嘉隼人
satoumikiwo	さとうみきを
mi	み
kuron	くろん
tomono	ともの
yukino	雪乃
ebicha	えびちゃ
futsun	ふつん
saku	さく
shitone	しとね
kiramaru	きらまる
ginineko	ぎに猫
narusehironori	なるせひろのり
tegomegu	テゴメグ
kaze	かぜ
chonchon	ちょんちょん
kimuramurasaki	木村紫
furahisa	フラヒサ
ayato	綾斗
marein	まれいん
kanami	かなみ
yoru	よる
rekigan	れきがん
kiyu	きゆ
fujiminoru	ふじみのる
yuu	ゆう
umako	うまこ
reto	レト
tomoka	ともか
yamineko	やみ猫
anzu	あんず
shimizu	清水
idekaze	いでかぜ
yukimaru	ゆきまる
ruko	ルコ
ore	俺
shinjisensei	シンジ先生
okamurasan	おかむらさん
monki	もんき
yuto	ゆと
takasaki	たかさき
kikkun	キックン
uraken	うらけん
pokepoke	ぽけぽけ
uchimomoniku	うちもも肉
nano	なの
enukko	えぬっこ
pokepoke	ぽけぽけ
fuwa	ふわ
ani	あに
machimi	まちみ
aporokiki	あぽろきき
usagichan	うさぎちゃん
nemu	ねむ
gauten	がうてん
geboku	下僕
yamatokkou	やまとっこう
maria	まりあ
mutou	無糖
tadachan	ただちゃん
masakari	マサカリ
okei	おけい
taimeshi	たいめし
bokenoko	ぼけのこ
koha	こは
kuma	くま
amanao	甘なお
asure	あすれ
momo	もも
naruseyuu	なるせゆう
nemutarou	ねむ太郎
akame	赤目
mayorun	まよるん
natane	なたね
ikuchan	郁ちゃん
mariru	まりる
ouka	桜花
nomeji	のめじ
saeba	さえば
baru	ばる
sakyo	サキョ
kaho	かほ
pikasan	ピカさん
kazu	カズ
garurun	ガルるん
pappurin	ぱっぷりん
fumiemon	ふみえもん
terumi	テルミ
watapan	わたぱん
kamo	かも
jorako	じょらこ
mei	めい
inazumakoto	いなづまこと
hanamin	ハナミン
maikacha	まいかちゃ
nasu	なす
natsu	なつ
pan	ぱん
tabigoma	たびゴマ
kiku	菊
shirono	しろの
kirimu	きりむ
risa	莉沙
maotarou	まおたろう
gokuraku	ごくらく
kitapaso	きたぱそ
aki	あき
mizukame	みずかめ
sasago	ささご
wasa	和佐
magaru	まがる
haruka	遥
rokushin	ろくしん
heiwanoryuu	平和の竜
ki	き
faru	ファル
muu	むう
tsukiyura	つきゆら
kuma	くま
miyumai	みゆまい
roku	ろく
manekichi	マネキチ
manekichi	マネキチ
koroku	ころく
ikaten	イカ天
fuyunonami	冬の波
haraheri	はらへり
kani	カニ
bunta	ブン太
nagi	なぎ
katakuri	カタクリ
akatsuki	暁
sasasuzu	笹鈴
denden	でんでん
onakasuita	おなかすいた
kodama	こだま
kodama	こだま
onakasuita	おなかすいた
onakasuita	おなかすいた
kodama	こだま
shiori	栞
kosodemochi	こそでもち
potepokari	ポテポカリ
potepokari	ポテポカリ
haruneko	はるねこ
haruneko	はるねこ
tomo	とも
tomo	とも
teru	てる
teru	てる
teru	てる
yananan	やななん
shinakun	シナくん
uguno	うぐの
furifurimomo	フリフリモモ
makarou	マカロゥ
nekoteru	ネコテル
hinata	ひなた
yukinko	ゆきんこ
fumikun	ふみくん
maurora	まうろら
komakoma	こまこま
hotochan	ほとちゃん
makitoma	まきとま
ippei	いっぺい
osusumepanda	おすすめパンダ
ootake	大竹
nekokan	猫缶
rande	ランデ
sharinuki	シャリぬき
murakumo	ムラクモ
tozamasan	とざまさん
yumechan	ゆめちゃん
monoai	ものあい
mouroku	もうろく
kyao	きゃお
tsudamakoto	津田真
asahi	あさひ
minomaru	みのまる
touji	冬至
piroki	ぴろき
nana	なな
tsukacho	つかちょ
himagami	ひまがみ
ai	藍
namamii	ナマミー
mitsuki	美月
satowa	さとわ
aoi	あおい
hanamaru	はなまる
watabou	わたぼう
maton	マトン
omega	オメガ
kurage	海月
serori	せろり
nyankomama	にゃんこママ
hikaruki	ひかるき
aoi	あおい
taisan	たいさん
furuponi	ふるぽに
kiki	キキ
annin	あんにん
fuuya	ふうや
yua	ゆあ
yuri	ゆり
ringoame	りんご飴
reina	れいな
puuma	プーマ
juda	じゅだ
mimiyo	みみよ
hanashiro	はなしろ
tenekura	てねくら
rei	零
pipikichi	ぴぴきち
masa	マサ
irodori	いろどり
hina	ひな
shiki	シキ
neko	ねこ
mayu	まゆ
tonkun	トンクン
miyuu	ミユウ
megumi	めぐみ
teruterunoumi	てるてる乃海
dachin	ダチン
masuni	ますに
yashiro	やしろ
tsuchio	ツチオ
koroku	ころく
mikarin	みかりん
momose	ももせ
merankorikun	メランコリくん
donabe	どなべ
yuzuki	ユズキ
horohoro	ホロホロ
kanata	かなた
katsuwo	カツヲ
senzai	せんざい
pokua	ぽくあ
sharon	シャロン
hakomaru	はこまる
osero	オセロ
ichamonten	以茶門天
hanamaru	はなまる
tanakapunie	田中ぷにえ
akazuki	あかずき
harukanata	ハルカナタ
rokumaru	六マル
shimamuu	しまむぅ
yuyu	ゆゆ
wao	わお
sakachan	さかちゃん
kuwaharagao	桑原ガオ
himawari	ひまわり
jikaidan	字怪談
tozamasan	とざまさん
arekku	アレック
futamaru	ふた丸
daifuku	だいふく
ouka	桜花
mon	もん
yamabuki	やまぶき
haneta	羽太
yasaka	やさか
rizu	りず
mitsuha	みつは
